16 16 16 16 16 16 16 16 16 16 16 16 16 16 16 16 16 16 16 16 16 16 16 16 16 16 16 16 16 16 16 16 16 16 16 16 16 16 16 16 16 16 16 16 16 16 16 16 16 16 16 16 16 16 16 16 16 16 16 16 16 16 16 16 16 16 16 16 16 16 16 16 16 16 16 16 16 16 16 16 16 16 16 16 16 16 16 16 16 16 16 16 16 16 16 16 16 16 16 16 
16 16 16 16 16 16 16 16 16 16 16 16 16 16 16 16 16 16 16 16 16 16 16 16 16 16 16 16 16 16 16 16 16 16 16 16 16 16 16 16 16 16 16 16 16 16 16 16 16 16 16 16 16 16 16 16 16 16 16 16 16 16 16 16 16 16 16 16 16 16 16 16 16 16 16 16 16 16 16 16 16 16 16 16 16 16 16 16 16 16 16 16 16 16 16 16 16 16 16 16 
16 16 16 16 16 16 16 16 16 16 16 16 16 16 16 16 16 16 16 16 16 16 16 16 16 16 16 16 16 16 16 16 16 16 16 16 16 16 16 16 16 16 16 16 16 16 16 16 16 16 16 16 16 16 16 16 16 16 16 16 16 16 16 16 16 16 16 16 16 16 16 16 16 16 16 16 16 16 16 16 16 16 16 16 16 16 16 16 16 16 16 16 16 16 16 16 16 16 16 16 
16 16 16 16 16 16 16 16 16 16 16 16 16 16 16 16 16 16 16 16 16 16 16 16 16 16 16 16 16 16 16 16 16 16 16 16 16 16 16 16 16 16 16 16 16 16 16 16 16 16 16 16 16 16 16 16 16 16 16 16 16 16 16 16 16 16 16 16 16 16 16 16 16 16 16 16 16 16 16 16 16 16 16 16 16 16 16 16 16 16 16 16 16 16 16 16 16 16 16 16 
16 16 16 16 16 16 16 16 16 16 16 16 16 16 16 16 16 16 16 16 16 16 16 16 16 16 16 16 16 16 16 16 16 16 16 16 16 16 16 16 16 16 16 16 16 16 16 16 16 16 16 16 16 16 16 16 16 16 16 16 16 16 16 16 16 16 16 16 16 16 16 16 16 16 16 16 16 16 16 16 16 16 16 16 16 16 16 16 16 16 16 16 16 16 16 16 16 16 16 16 
16 16 16 16 16 16 16 16 16 16 16 16 16 16 16 16 16 16 16 16 16 16 16 16 16 16 16 16 16 16 16 16 16 16 16 16 16 16 16 16 16 16 16 16 16 16 16 16 16 16 16 16 16 16 16 16 16 16 16 16 16 16 16 16 16 16 16 16 16 16 16 16 16 16 16 16 16 16 16 16 16 16 16 16 16 16 16 16 16 16 16 16 16 16 16 16 16 16 16 16 
16 16 16 16 16 16 16 16 16 16 16 16 16 16 16 16 16 16 16 16 16 16 16 16 16 16 16 16 16 16 16 16 16 16 16 16 16 16 16 16 16 16 16 16 16 16 16 16 16 16 16 16 16 16 16 16 16 16 16 16 16 16 16 16 16 16 16 16 16 16 16 16 16 16 16 16 16 16 16 16 16 16 16 16 16 16 16 16 16 16 16 16 16 16 16 16 16 16 16 16 
16 16 16 16 16 16 16 16 16 16 16 16 16 16 16 16 16 16 16 16 16 16 16 16 16 16 16 16 16 16 16 16 16 16 16 16 16 16 16 16 16 16 16 16 16 16 16 16 16 16 16 16 16 16 16 16 16 16 16 16 16 16 16 16 16 16 16 16 16 16 16 16 16 16 16 16 16 16 16 16 16 16 16 16 16 16 16 16 16 16 16 16 16 16 16 16 16 16 16 16 
16 16 16 16 16 16 16 16 16 16 16 16 16 16 16 16 16 16 16 16 16 16 16 16 16 16 16 16 16 16 16 16 16 16 16 16 16 16 16 16 16 16 16 16 16 16 16 16 16 16 16 16 16 16 16 16 16 16 16 16 16 16 16 16 16 16 16 16 16 16 16 16 16 16 16 16 16 16 16 16 16 16 16 16 16 16 16 16 16 16 16 16 16 16 16 16 16 16 16 16 
16 16 16 16 16 16 16 16 16 16 16 16 16 16 16 16 16 16 16 16 16 16 16 16 16 16 16 16 16 16 16 16 16 16 16 16 16 16 16 16 16 16 16 16 16 16 16 16 16 16 16 16 16 16 16 16 16 16 16 16 16 16 16 16 16 16 16 16 16 16 16 16 16 16 16 16 16 16 16 16 16 16 16 16 16 16 16 16 16 16 16 16 16 16 16 16 16 16 16 16 
16 16 16 16 16 16 16 16 16 16 16 16 16 16 16 16 16 27 24 24 24 24 24 24 24 24 24 24 24 24 24 24 24 24 24 24 24 24 24 24 24 24 24 24 24 24 24 28 16 16 16 16 16 16 16 16 16 16 16 16 16 16 16 16 16 16 16 16 16 16 16 16 16 16 16 16 16 16 16 16 16 16 16 16 16 16 16 16 16 16 16 16 16 16 16 16 16 16 16 16 
16 16 16 16 16 16 16 16 16 16 16 16 16 16 16 16 16 22 33 33 33 33 40 40 40 40 40 40 40 40 40 40 40 40 40 40 40 40 40 40 40 40 40 40 40 40 40 23 28 16 16 16 16 16 16 16 16 16 16 16 16 16 16 16 16 16 16 16 16 16 16 16 16 16 16 16 16 16 16 16 16 16 16 16 16 16 16 16 16 16 16 16 16 16 16 16 16 16 16 16 
16 16 16 16 16 16 16 16 16 16 16 16 16 16 16 16 16 22 33 33 40 40 40 91 11 11 11 11 11 11 11 11 11 11 11 11 11 11 11 11 11 11 11 11 11 1 34 40 21 16 16 16 16 16 16 16 16 16 16 16 16 16 16 16 16 16 16 16 16 16 16 16 16 16 16 16 16 16 16 16 16 16 16 16 16 16 16 16 16 16 16 16 16 16 16 16 16 16 16 16 
16 16 16 16 16 16 16 16 16 16 16 16 16 16 16 16 16 22 33 33 94 91 11 7 9 9 9 9 9 9 9 9 9 9 9 9 9 9 9 9 9 9 9 9 6 80 34 40 21 16 16 16 16 16 16 16 16 16 16 16 16 16 16 16 16 16 16 16 16 16 16 16 16 16 16 16 16 16 16 16 16 16 16 16 16 16 16 16 16 16 16 16 16 16 16 16 16 16 16 16 
16 16 16 16 16 16 16 16 16 16 16 16 16 16 16 16 16 22 33 33 91 7 9 9 9 9 9 9 9 9 9 9 9 9 9 9 9 9 9 9 9 9 9 6 80 34 40 18 30 16 16 16 16 16 16 16 16 16 16 16 16 16 16 16 16 16 16 16 16 16 16 16 16 16 16 16 16 16 16 16 16 16 16 16 16 16 16 16 16 16 16 16 16 16 16 16 16 16 16 16 
16 16 16 16 16 16 16 16 16 16 16 16 16 16 16 16 16 22 33 91 7 9 9 9 9 9 9 9 9 9 9 9 9 9 9 9 9 9 9 9 9 9 6 80 34 40 40 21 16 16 16 16 16 16 16 16 16 16 16 16 16 16 16 16 16 16 16 16 16 16 16 16 16 16 16 16 16 16 16 16 16 16 16 16 16 16 16 16 16 16 16 16 16 16 16 16 16 16 16 16 
16 16 16 16 16 16 16 16 16 16 16 16 16 16 16 16 27 26 91 7 9 9 9 9 9 9 9 9 9 9 9 9 9 9 9 9 9 9 9 9 9 9 10 34 34 40 18 30 16 16 16 16 16 16 16 16 16 16 16 16 16 16 16 16 16 16 16 16 16 16 16 16 16 16 16 16 16 16 16 16 16 16 16 16 16 16 16 16 16 16 16 16 16 16 16 16 16 16 16 16 
16 16 16 16 16 16 16 16 16 16 16 16 16 16 16 27 26 91 7 9 9 9 9 9 9 9 9 9 9 9 9 9 9 9 9 9 9 9 9 9 9 9 10 34 40 40 21 16 16 16 16 16 16 16 16 16 16 16 16 16 16 16 16 16 16 16 16 16 16 16 16 16 16 16 16 16 16 16 16 16 16 16 16 16 16 16 16 16 16 16 16 16 16 16 16 16 16 16 16 16 
16 16 16 16 16 16 16 16 16 16 16 16 16 16 16 22 91 7 9 9 9 9 9 9 9 9 9 9 9 9 9 9 9 9 9 9 9 9 9 9 9 9 10 34 18 19 30 16 16 16 16 16 16 16 16 16 16 16 16 16 16 16 16 16 16 16 16 16 16 16 16 16 16 16 16 16 16 16 16 16 16 16 16 16 16 16 16 16 16 16 16 16 16 16 16 16 16 16 16 16 
16 16 16 16 16 16 16 16 16 16 16 16 16 16 16 22 69 5 5 5 5 5 5 5 5 5 5 5 5 5 5 5 5 5 5 5 5 5 5 5 5 5 80 34 21 16 16 27 24 24 24 24 24 24 24 24 24 24 24 24 24 24 24 24 24 24 24 24 24 24 24 24 24 24 24 24 24 24 24 24 24 24 28 16 16 16 16 16 16 16 16 16 16 16 16 16 16 16 16 16 
16 16 16 16 16 16 16 16 16 16 16 16 16 16 16 29 19 20 32 32 40 40 40 40 40 40 40 40 40 40 32 32 32 32 32 32 32 32 32 32 32 32 32 34 21 16 16 22 40 40 40 40 40 40 91 11 11 11 11 11 1 40 40 40 40 40 40 40 40 40 40 40 40 40 40 40 40 41 40 40 40 40 21 16 16 16 16 16 16 16 16 16 16 16 16 16 16 16 16 16 
16 16 16 16 16 16 16 16 16 16 16 16 16 16 16 16 16 22 32 40 40 44 44 44 44 44 44 40 40 40 32 40 90 92 93 40 32 40 90 92 93 40 32 34 21 17 16 22 40 40 40 40 40 40 8 9 9 9 9 9 13 1 41 40 40 40 40 40 40 40 40 40 40 40 40 40 40 40 40 40 41 40 21 16 16 16 16 16 16 16 16 16 16 16 16 16 16 16 16 16 
16 16 16 16 16 16 16 16 16 16 16 16 16 16 16 16 16 22 43 40 44 44 44 44 44 44 44 40 40 40 32 40 84 85 86 40 32 40 84 85 86 40 32 34 21 16 16 29 20 40 40 40 40 40 8 9 9 9 9 9 9 10 40 40 40 40 40 40 40 40 40 40 40 40 40 40 40 40 63 64 65 40 21 16 16 16 16 16 16 16 16 16 16 16 16 16 16 16 16 16 
16 16 16 16 16 16 16 16 16 16 16 16 16 16 16 16 16 22 40 40 44 44 44 40 40 40 40 40 40 42 32 40 81 82 83 40 32 40 81 82 83 40 32 34 34 16 16 16 29 20 40 40 40 40 69 12 9 9 9 9 9 10 40 40 40 40 40 40 40 40 40 40 40 40 40 40 40 41 56 57 59 40 21 16 16 16 16 16 16 16 16 16 16 16 16 16 16 16 16 16 
16 16 16 16 16 16 16 16 16 16 16 16 16 16 16 16 16 22 40 44 44 44 44 40 40 40 91 11 11 1 32 40 87 88 89 40 32 40 87 88 89 40 32 34 34 34 16 16 16 16 34 34 40 40 40 69 5 12 9 9 9 10 40 40 40 40 40 40 40 40 40 40 40 40 40 40 40 41 53 54 55 40 21 16 16 16 16 16 16 16 16 16 16 16 16 16 16 16 16 16 
16 16 16 16 16 16 16 16 16 16 16 16 16 16 16 16 16 22 40 40 40 40 40 40 40 42 69 5 5 80 0 3 3 3 3 3 3 3 3 3 3 14 40 40 34 34 16 17 16 16 16 34 34 40 40 40 40 69 5 5 5 80 40 41 40 40 40 40 40 40 40 40 40 40 40 40 40 40 60 61 62 40 21 16 16 16 16 16 16 16 16 16 16 16 16 16 16 16 16 16 
16 16 16 16 16 16 16 16 16 16 16 16 16 16 16 16 16 22 40 40 43 40 40 40 40 40 40 40 40 40 25 98 98 98 98 98 99 97 98 98 98 36 40 40 91 11 11 1 16 16 16 16 34 34 34 40 40 40 40 40 40 40 40 40 40 40 40 40 40 40 40 40 40 40 40 40 40 40 91 1 40 40 21 16 16 16 16 16 16 16 16 16 16 16 16 16 16 16 16 16 
16 16 16 16 16 16 16 16 16 16 16 16 16 16 16 16 16 22 40 40 40 42 43 42 40 40 18 19 19 19 19 19 19 19 19 20 101 100 18 19 19 20 40 33 8 9 9 13 1 16 17 16 16 34 34 40 40 40 40 40 40 41 40 40 40 40 41 40 40 40 40 40 40 40 40 40 40 40 8 13 11 1 21 16 16 16 16 16 16 16 16 16 16 16 16 16 16 16 16 16 
16 16 16 16 16 16 16 16 16 16 16 16 16 16 16 16 16 22 40 40 40 40 40 40 40 40 21 16 16 16 16 16 16 16 16 22 101 100 21 16 16 29 19 20 69 12 9 9 10 34 34 16 16 16 34 34 34 40 40 40 40 40 40 40 40 40 40 40 40 40 40 40 40 40 40 40 40 40 8 9 9 10 21 16 16 16 16 16 16 16 16 16 16 16 16 16 16 16 16 16 
16 16 16 16 16 16 16 16 16 16 16 16 16 16 16 16 16 22 40 40 40 40 40 40 40 40 21 16 16 16 17 16 16 16 17 22 101 100 21 16 16 16 17 29 20 8 9 9 13 1 34 34 16 16 16 34 34 34 34 34 40 40 40 41 40 40 40 40 41 40 40 40 40 40 40 40 40 40 8 9 9 10 21 16 16 16 16 16 16 16 16 16 16 16 16 16 16 16 16 16 
16 16 16 16 16 16 16 16 16 16 16 16 16 16 16 16 16 22 40 40 40 40 40 40 40 40 23 28 16 16 16 16 16 16 16 22 101 100 21 16 17 16 16 16 22 8 9 9 9 13 11 1 34 16 16 22 40 21 34 34 34 34 40 40 40 40 40 40 40 40 40 40 40 40 40 40 40 41 69 5 5 80 21 16 16 16 16 16 16 16 16 16 16 16 16 16 16 16 16 16 
16 16 16 16 16 16 16 16 16 16 16 16 16 16 16 16 16 22 40 40 40 40 40 40 40 33 33 21 16 16 16 16 17 16 16 22 101 100 21 16 17 16 17 16 22 8 9 9 9 9 9 13 11 1 16 22 40 21 16 16 34 34 34 40 40 40 40 40 40 40 40 40 40 40 40 40 40 40 40 40 40 40 21 16 16 16 16 16 16 16 16 16 16 16 16 16 16 16 16 16 
16 16 16 16 16 16 16 16 16 16 16 16 16 16 16 16 16 22 40 40 40 40 40 40 33 33 33 23 24 28 16 16 16 16 16 22 101 100 21 16 16 16 16 16 22 8 9 9 9 9 9 9 9 13 11 1 40 21 16 16 16 16 34 34 34 34 34 34 34 34 34 34 40 40 40 40 40 40 40 40 40 40 21 16 16 16 16 16 16 16 16 16 16 16 16 16 16 16 16 16 
16 16 16 16 16 16 16 16 16 16 16 16 16 16 16 16 16 22 40 40 40 40 40 40 33 33 33 33 33 23 24 24 24 24 24 26 101 100 23 24 24 24 24 24 26 69 5 5 5 5 5 5 5 5 5 80 40 40 33 16 17 16 16 16 16 34 34 34 34 34 34 34 34 40 40 40 40 40 40 41 40 40 21 16 16 16 16 16 16 16 16 16 16 16 16 16 16 16 16 16 
16 16 16 16 16 16 16 16 16 16 16 16 16 16 16 16 16 22 40 40 40 91 11 11 11 11 11 11 11 11 11 1 33 33 40 40 101 2 3 3 3 3 3 3 3 3 3 3 3 3 3 3 3 3 14 40 40 91 11 1 16 16 16 16 16 16 16 16 17 16 16 34 34 34 34 34 40 40 40 40 40 40 21 16 16 91 11 11 11 11 11 11 1 16 16 16 16 16 16 16 
16 16 16 16 16 16 16 16 16 16 16 16 16 16 16 16 16 22 40 41 91 7 9 9 9 9 9 9 9 9 9 10 33 33 40 40 25 98 98 98 98 98 98 98 98 98 98 98 98 98 98 98 99 96 100 91 11 7 9 10 16 16 17 16 16 16 16 17 16 16 16 16 16 34 34 34 34 34 34 34 40 40 21 16 16 69 12 9 9 9 9 9 10 24 24 24 24 24 28 16 
16 16 16 16 16 16 16 16 16 16 16 16 16 16 16 16 16 22 40 40 8 9 9 9 9 9 9 9 9 9 9 13 11 11 11 11 11 11 11 11 11 11 11 11 11 11 11 11 11 11 11 1 101 96 100 8 9 9 9 10 16 16 16 16 16 16 16 16 16 16 16 16 16 17 16 16 34 34 34 34 34 41 21 16 16 91 7 9 9 9 9 9 10 40 40 40 40 40 21 16 
16 16 16 16 16 16 16 16 16 16 16 16 16 16 16 16 16 22 40 40 8 9 9 9 9 9 9 9 9 9 9 9 9 9 9 9 9 9 9 9 9 9 9 9 9 9 9 9 9 9 9 10 101 96 100 8 9 9 9 10 16 16 16 16 16 40 91 11 11 11 1 16 16 16 16 16 16 17 16 16 16 16 16 16 16 69 12 9 9 9 9 9 10 40 40 40 40 40 21 16 
16 16 16 16 16 16 16 16 16 16 16 16 16 16 27 24 24 26 40 40 69 12 9 9 9 9 9 9 9 9 9 9 9 9 9 9 9 9 9 9 9 9 9 9 9 9 9 9 9 9 9 10 101 96 100 69 5 5 5 80 24 24 24 24 24 40 69 12 9 9 13 11 11 1 16 16 16 16 16 16 91 11 11 11 11 11 7 6 5 5 5 5 80 40 40 40 40 40 21 16 
16 16 16 16 16 16 16 16 16 16 16 16 16 16 22 40 40 40 40 40 40 8 9 9 9 9 9 9 9 9 9 9 9 9 9 9 9 9 9 9 9 9 9 9 9 9 9 9 9 9 9 10 101 96 100 40 40 40 40 40 40 40 40 40 40 40 40 8 9 9 9 9 9 13 11 11 11 11 11 11 7 9 9 9 9 9 9 10 40 40 40 40 40 40 40 40 40 40 21 16 
16 16 16 16 16 16 16 16 16 16 16 16 16 16 22 43 43 43 43 43 40 69 5 5 5 5 5 12 9 9 9 9 9 9 9 9 9 9 9 9 9 9 9 9 9 9 9 9 9 9 9 10 101 96 100 91 11 11 11 11 1 19 19 19 19 40 40 69 5 5 12 6 5 5 5 5 5 5 12 9 9 9 9 9 9 9 9 10 40 40 40 40 76 77 78 40 40 40 21 16 
16 16 16 16 16 16 16 16 16 16 16 16 16 16 22 43 43 43 43 40 40 40 40 40 40 40 40 69 5 5 5 5 5 5 5 5 5 5 5 5 5 5 5 5 12 9 9 9 9 9 9 10 101 96 100 8 9 9 9 9 10 16 16 16 16 42 40 40 40 40 8 10 40 44 44 44 44 40 8 9 9 9 9 9 9 9 9 10 40 40 40 40 70 71 72 40 40 40 21 16 
16 16 16 16 16 16 16 16 16 16 16 16 16 16 22 43 43 43 40 40 40 40 40 40 40 40 40 40 40 40 40 40 40 40 40 40 40 40 40 40 40 40 40 94 8 9 9 9 9 9 9 10 101 96 100 8 9 9 6 5 80 16 16 16 16 40 91 11 1 40 8 10 41 91 11 11 1 40 8 9 9 6 5 5 12 9 9 10 40 40 40 40 66 68 67 40 40 40 21 16 
16 16 16 16 16 16 16 16 16 16 16 16 16 16 22 43 43 43 40 33 33 33 33 33 33 33 33 33 33 33 33 33 33 33 33 33 33 33 33 33 33 33 33 33 8 9 9 9 9 9 9 10 101 96 100 8 9 9 10 34 34 16 16 17 16 16 69 12 10 40 8 10 42 8 9 6 80 40 69 5 5 80 40 41 8 9 9 10 40 40 40 40 73 74 75 40 40 40 21 16 
16 16 16 16 16 16 16 16 16 16 16 16 16 16 22 43 43 43 40 33 40 40 40 40 41 40 40 33 40 40 40 40 40 40 40 33 40 40 40 40 40 40 40 33 8 9 9 9 9 9 9 10 101 96 100 8 9 9 10 40 34 34 16 16 16 16 40 8 10 34 69 80 42 8 9 10 40 40 40 40 44 44 40 41 69 5 5 80 40 40 40 40 40 40 40 40 40 40 21 16 
16 16 16 16 16 16 16 16 16 16 16 16 16 16 22 43 43 43 40 33 40 32 40 40 40 40 40 33 40 42 40 40 40 31 40 33 40 40 40 40 40 42 40 33 8 9 9 9 9 9 9 10 101 96 100 8 9 9 13 11 1 34 34 16 16 16 16 69 80 34 34 34 40 8 9 13 11 11 11 11 1 44 40 40 40 33 40 40 40 40 40 40 40 40 40 40 40 40 21 16 
16 16 16 16 16 16 16 16 16 16 16 16 16 16 22 43 43 40 40 33 40 40 63 64 65 40 40 33 40 40 76 77 78 40 40 33 40 40 76 77 78 40 40 33 8 9 9 9 9 9 9 10 101 96 100 8 9 9 9 9 10 40 34 34 34 16 16 16 16 34 91 11 11 7 9 9 9 9 9 9 10 41 40 40 40 33 40 40 40 40 40 40 40 40 40 19 19 19 30 16 
16 16 16 16 16 16 16 16 16 16 16 16 16 16 22 40 40 40 40 33 40 40 56 57 59 41 40 33 40 40 70 71 72 40 40 33 40 40 70 71 72 40 40 33 8 9 9 9 9 9 9 10 101 96 100 8 9 9 9 9 13 11 11 11 1 34 34 16 16 34 69 5 5 5 12 9 9 9 9 9 13 11 11 11 11 11 11 11 11 1 40 40 40 40 19 16 16 16 16 16 
16 16 16 16 16 16 16 16 16 16 16 16 16 16 22 40 43 40 40 33 40 40 53 54 55 40 40 33 40 40 66 68 67 40 40 33 40 40 66 68 67 40 40 33 8 9 9 9 9 9 9 10 101 96 100 8 9 9 9 9 9 9 9 9 10 34 34 34 16 34 34 34 34 34 69 5 5 5 5 5 5 5 5 5 5 5 5 5 5 80 19 19 19 19 16 16 16 16 16 16 
16 16 16 16 16 16 16 16 16 16 16 16 16 16 22 43 43 40 40 33 40 40 60 61 62 40 40 33 40 40 40 40 42 40 40 33 42 40 40 40 40 42 40 33 8 9 9 9 9 9 9 10 101 96 100 8 9 9 9 9 9 9 9 9 13 1 34 34 34 16 16 17 34 34 34 34 16 16 16 16 16 16 16 16 16 16 16 16 16 16 16 16 16 16 16 16 16 16 16 16 
16 16 16 16 16 16 16 16 16 16 16 16 16 16 22 43 40 40 40 33 43 40 0 3 14 40 40 33 40 40 0 3 14 40 40 33 40 40 0 3 14 40 40 33 69 5 5 5 5 5 5 80 101 96 100 69 5 5 5 5 5 5 12 9 9 13 11 1 34 34 34 16 16 16 16 16 16 16 16 16 16 16 16 16 16 16 16 16 16 16 16 16 16 16 16 16 16 16 16 16 
16 16 16 16 16 16 16 16 16 16 17 16 16 16 22 91 1 40 41 40 40 40 101 96 2 3 3 3 3 3 4 96 2 3 3 3 3 3 4 96 2 3 3 3 3 3 3 3 3 3 3 3 4 96 2 3 3 3 3 14 91 11 7 9 9 9 9 13 11 11 1 34 34 34 34 34 34 34 34 16 16 16 16 16 16 16 16 16 16 16 16 16 16 16 16 16 16 16 16 16 
16 16 16 16 16 16 16 16 16 16 16 16 16 16 22 69 80 40 40 40 40 40 101 96 96 96 96 96 96 96 96 96 96 96 96 96 96 96 96 96 96 96 96 96 96 96 96 96 96 96 96 96 96 96 96 96 96 96 96 100 8 9 9 9 9 9 9 9 9 9 13 11 11 1 34 34 34 34 34 34 34 34 34 34 16 34 34 91 1 16 16 16 16 16 16 16 16 16 16 16 
16 16 16 16 16 16 16 16 16 16 17 16 16 16 22 40 40 43 40 40 41 40 101 96 97 98 98 98 98 98 99 96 97 98 98 98 98 98 99 96 97 98 98 98 98 98 98 98 98 98 98 98 98 98 98 98 98 99 97 36 8 9 9 9 9 9 9 9 9 9 9 9 9 13 11 11 11 11 11 11 11 1 40 34 34 34 91 7 13 11 1 16 16 16 16 16 16 16 16 16 
16 16 16 16 16 16 16 17 16 16 16 16 16 16 22 40 40 40 40 33 40 40 101 96 100 40 40 33 40 40 101 96 100 40 40 33 40 40 101 96 100 40 40 33 91 11 11 11 11 11 11 11 11 11 1 40 40 101 100 91 7 9 9 9 9 9 9 9 9 9 9 9 9 9 9 9 9 9 9 9 9 10 76 77 78 91 7 9 9 9 13 1 16 16 16 16 16 16 16 16 
16 16 16 16 16 16 16 16 16 16 16 16 17 16 22 40 40 40 40 33 40 40 101 96 100 40 40 33 40 40 101 96 100 40 40 33 40 40 101 96 100 40 40 33 8 9 9 9 9 9 9 9 9 9 13 1 40 101 100 8 9 9 9 9 9 9 9 9 9 9 9 9 9 9 9 9 9 9 9 6 5 80 70 71 72 8 9 9 9 9 9 13 11 11 11 1 16 16 16 16 
16 16 16 16 16 16 16 16 16 16 16 16 16 16 22 40 40 40 40 33 40 40 25 98 36 40 40 33 40 40 25 98 36 41 40 33 40 40 25 98 36 40 40 33 8 9 9 9 9 9 9 9 9 9 9 13 1 101 100 8 9 9 9 9 9 9 9 9 9 9 9 9 9 9 9 9 9 6 5 80 40 94 66 68 67 8 9 9 9 9 9 9 9 9 9 13 11 11 11 11 
16 16 16 16 16 16 16 16 16 16 16 17 16 16 22 40 43 40 40 33 40 42 76 77 78 40 40 33 40 40 76 77 78 42 40 33 40 40 76 77 78 40 40 33 8 9 9 9 9 9 9 9 9 9 9 9 10 25 36 8 9 9 9 9 9 9 9 9 6 5 5 5 5 5 5 5 5 80 40 40 40 40 91 11 11 7 9 9 9 9 9 9 9 9 9 9 9 9 9 9 
16 16 16 16 16 16 16 16 16 17 16 16 16 16 22 40 40 40 40 33 40 40 70 71 72 40 40 33 40 40 70 71 72 40 40 33 40 40 70 71 72 42 40 33 8 9 9 9 9 9 9 9 9 9 9 9 10 40 40 8 9 9 9 9 9 9 6 5 80 40 40 40 42 42 40 40 40 40 40 40 40 91 7 9 9 9 9 9 9 9 9 9 9 9 9 9 9 9 9 9 
16 16 16 16 16 16 16 16 16 16 16 16 16 16 22 40 40 40 40 33 40 40 66 68 67 40 40 33 40 40 66 68 67 40 40 33 40 40 66 68 67 40 40 33 8 9 9 9 9 9 9 9 9 9 9 9 10 0 14 8 9 9 9 9 9 6 80 40 40 40 40 40 43 43 43 43 40 44 44 44 40 8 9 9 9 9 9 9 9 9 9 9 9 9 9 9 9 9 9 9 
16 16 16 16 16 16 16 16 17 16 16 17 16 16 22 40 40 40 40 33 40 40 40 40 40 40 40 33 40 40 40 40 40 40 40 33 40 40 40 40 40 40 40 33 8 9 9 9 9 9 9 9 9 9 9 9 10 101 100 69 5 5 5 5 5 80 40 40 40 40 40 40 40 40 40 40 40 40 40 40 40 69 12 9 9 9 9 9 9 9 9 9 9 9 9 9 9 9 9 9 
16 16 16 16 16 16 16 16 16 16 16 16 16 16 22 43 40 40 40 33 40 44 40 40 40 42 40 33 40 44 44 44 40 40 40 33 32 44 44 44 44 31 40 33 8 9 9 9 9 9 9 9 9 9 9 6 80 101 2 3 3 3 3 3 3 3 3 3 3 3 3 3 3 3 3 3 3 3 3 3 3 3 8 9 9 9 9 9 9 9 9 9 9 9 9 9 9 9 9 9 
16 16 16 16 16 16 16 16 16 16 16 16 16 16 22 43 43 43 40 33 33 33 33 33 33 33 33 33 33 33 33 33 33 33 33 33 33 33 33 33 33 33 33 33 8 9 9 9 9 9 9 9 6 5 5 80 40 25 98 98 98 98 98 98 98 98 98 98 98 98 98 98 98 98 98 98 98 98 98 98 98 98 8 9 9 9 9 9 9 9 9 9 9 9 9 9 9 9 9 9 
16 16 16 16 16 16 16 16 16 16 16 16 16 16 22 43 43 43 43 40 40 40 40 40 40 40 40 40 40 40 40 40 40 40 40 40 40 40 40 40 40 40 40 91 7 9 9 6 5 5 5 5 80 40 40 40 40 40 33 33 40 40 40 40 40 40 40 40 40 40 91 11 11 11 11 1 40 40 40 40 40 91 7 9 9 9 9 9 9 9 9 9 9 9 9 9 9 9 9 9 
16 16 16 16 16 16 16 16 16 16 16 16 27 24 26 40 43 43 43 91 11 11 1 43 40 40 40 40 40 40 40 40 40 40 40 40 40 40 40 40 40 40 91 7 9 9 6 80 18 19 19 19 19 19 19 19 19 19 20 91 11 11 11 11 11 11 11 11 11 11 7 9 9 9 9 10 40 40 40 40 91 7 9 9 9 9 9 9 9 9 9 9 9 9 9 9 9 9 9 9 
16 16 16 16 16 16 16 16 16 16 16 16 22 40 40 43 43 43 91 7 9 9 13 1 40 40 40 40 40 40 40 40 40 40 40 40 40 0 14 40 40 40 8 9 9 9 10 18 30 16 16 16 16 16 16 16 16 17 22 8 9 9 9 9 9 9 9 9 9 9 9 9 6 5 5 80 40 40 40 91 7 9 9 6 5 5 5 5 5 5 5 5 5 5 5 5 5 5 5 5 
16 16 16 16 16 16 16 16 16 16 27 24 26 40 40 43 91 11 7 6 5 5 5 80 40 40 40 40 40 40 40 40 40 40 40 40 40 101 100 40 40 40 8 9 9 9 10 21 16 16 16 16 16 16 16 16 27 24 26 8 9 9 9 9 9 9 9 9 9 9 9 6 80 40 40 40 40 40 91 7 9 9 9 10 18 19 19 19 19 19 19 19 19 19 19 19 19 19 19 19 
16 16 16 16 16 16 16 16 16 16 22 40 40 40 91 11 7 9 9 10 0 3 3 3 3 3 3 3 3 3 3 3 3 3 3 3 3 4 2 3 14 91 7 9 9 9 10 21 16 16 17 16 16 17 16 16 29 19 20 8 9 9 9 9 9 9 9 9 9 9 9 10 40 40 91 11 11 11 7 9 9 9 9 10 21 16 16 16 16 16 16 16 16 16 16 16 16 16 16 16 
16 16 16 16 16 16 16 16 16 27 26 40 40 40 8 9 9 9 9 10 101 97 98 98 98 98 98 98 98 98 98 98 98 98 98 98 98 98 98 99 100 8 9 9 6 5 80 21 16 16 16 16 16 16 16 16 16 27 26 8 9 9 9 9 9 9 9 9 9 9 6 80 40 91 7 9 9 9 9 9 9 9 9 10 21 16 16 16 16 16 16 16 16 16 16 16 16 16 16 16 
16 16 16 16 16 27 24 24 24 26 40 40 40 91 7 6 5 5 5 80 101 100 40 42 40 42 40 40 40 42 40 40 40 40 40 40 40 40 40 101 100 8 9 9 10 40 94 21 16 16 17 16 16 16 27 24 24 26 33 69 5 5 5 5 12 9 9 9 9 6 80 40 40 8 9 9 9 9 9 9 9 9 9 10 21 16 16 16 16 16 16 16 16 16 16 16 16 16 16 16 
16 16 16 16 16 22 40 40 40 40 40 91 11 7 9 10 32 32 32 32 101 100 40 40 44 40 40 40 40 40 40 18 19 19 19 19 19 20 40 101 100 8 9 9 10 40 40 23 28 16 16 16 16 27 26 40 40 40 40 40 40 40 40 40 69 5 5 5 5 80 40 40 40 8 9 9 9 9 9 9 9 9 9 10 21 16 16 16 16 16 16 16 16 16 16 16 16 16 16 16 
16 16 16 16 16 22 40 34 34 40 91 7 9 9 6 80 76 77 78 40 101 100 40 42 40 40 40 40 40 42 40 21 16 16 16 16 16 29 20 101 100 69 12 9 10 40 40 40 23 24 24 24 24 26 40 40 40 40 40 40 40 40 40 40 40 40 40 40 40 40 40 91 11 7 9 9 9 9 9 9 9 9 9 10 21 16 16 16 16 16 16 16 16 16 16 16 16 16 16 16 
16 16 16 16 16 22 40 34 34 34 69 12 9 9 13 1 70 71 72 40 101 100 40 40 40 40 42 40 40 42 40 21 17 16 16 16 16 16 22 101 100 40 69 12 13 11 1 40 40 40 40 42 42 40 40 40 40 40 40 40 40 40 40 40 40 40 40 40 40 40 40 8 9 9 9 9 9 9 9 9 9 9 9 10 21 16 16 16 16 16 16 16 16 16 16 16 16 16 16 16 
16 16 16 16 16 22 33 41 34 34 34 8 9 9 9 10 66 68 67 40 101 100 42 40 40 42 91 11 11 1 18 30 16 16 16 16 16 16 22 101 100 40 91 7 9 9 13 1 40 40 40 42 42 40 40 40 40 40 40 40 0 3 3 3 3 3 3 3 14 40 91 7 9 9 9 9 9 9 9 9 9 9 6 80 21 16 16 16 16 16 16 16 16 16 16 16 16 16 16 16 
16 16 16 16 16 22 33 33 34 35 34 8 9 9 9 13 1 40 40 40 101 100 40 41 40 91 7 9 9 10 21 16 16 17 16 16 17 27 26 101 100 40 8 9 9 9 9 10 40 40 40 42 42 40 40 40 40 40 40 40 101 97 98 98 98 98 98 98 36 40 8 9 9 9 9 9 9 9 9 9 9 6 80 40 21 16 16 16 16 16 16 16 16 16 16 16 16 16 16 16 
16 16 16 16 16 22 33 91 11 11 11 7 9 9 9 9 10 40 40 40 101 100 40 91 11 7 9 9 9 10 23 28 16 16 16 16 27 26 40 101 100 40 8 9 9 9 9 13 1 0 3 3 3 3 3 3 3 3 3 3 4 100 40 40 40 40 40 40 40 40 8 9 9 9 9 9 9 9 9 9 9 10 40 94 21 16 16 16 16 16 16 16 16 16 16 16 16 16 16 16 
16 16 16 16 16 22 91 7 9 9 9 9 9 9 9 9 13 1 40 40 101 100 40 8 9 9 9 9 6 80 32 23 24 28 16 27 26 40 40 101 100 40 8 9 9 9 9 9 10 25 98 98 98 98 98 98 98 98 98 98 98 36 40 40 40 40 40 40 40 40 8 9 9 9 9 9 9 9 9 9 6 80 40 40 21 16 16 16 16 16 16 16 16 16 16 16 16 16 16 16 
16 16 16 16 16 22 69 12 9 9 9 9 9 9 9 9 9 13 1 40 101 100 40 8 9 9 9 6 80 42 32 32 32 23 24 26 33 40 40 25 36 40 8 9 9 9 9 9 10 40 40 40 40 40 40 40 40 40 40 40 40 40 40 40 40 40 40 40 40 40 8 9 9 9 9 9 9 9 6 5 80 40 40 40 21 16 16 16 16 16 16 16 16 16 16 16 16 16 16 16 
16 16 16 16 16 22 91 7 9 9 9 9 9 9 9 9 9 9 13 1 101 100 40 69 5 5 5 80 42 42 40 40 40 94 91 11 1 33 40 40 40 40 8 9 9 9 9 9 10 40 40 40 40 40 40 40 40 40 40 40 44 40 40 40 40 40 40 40 40 40 69 5 5 5 5 5 5 5 80 40 40 40 40 40 21 16 16 16 16 16 16 16 16 16 16 16 16 16 16 16 
16 16 16 16 16 22 69 12 9 9 9 9 9 9 9 9 9 9 6 80 101 100 40 40 40 40 40 40 40 91 11 11 11 11 7 9 10 33 33 40 40 94 69 5 12 9 9 9 13 11 11 11 11 1 40 40 40 40 40 44 44 44 44 40 40 40 40 40 40 40 40 40 40 40 40 40 40 40 40 40 40 40 40 40 40 21 16 16 16 16 16 16 16 16 16 16 16 16 16 16 
16 16 16 16 16 22 91 7 9 9 9 9 9 9 9 9 9 9 10 40 101 100 76 77 78 40 40 40 91 7 9 9 9 9 6 5 80 18 19 19 19 19 19 20 69 12 9 9 9 9 9 9 9 10 40 40 40 40 40 40 44 40 40 40 40 40 40 40 40 40 40 40 40 40 40 40 40 40 40 40 40 40 40 40 40 21 16 16 16 16 16 16 16 16 16 16 16 16 16 16 
16 16 16 16 16 22 69 12 9 9 9 9 9 9 9 9 9 9 10 40 101 100 70 71 72 40 91 11 7 9 9 9 9 9 13 11 1 21 16 16 16 16 16 22 40 8 9 9 9 9 9 9 9 10 40 40 40 40 40 40 40 40 40 40 40 40 40 40 40 40 40 40 40 40 40 40 40 40 40 40 40 40 40 40 40 21 16 16 16 16 16 16 16 16 16 16 16 16 16 16 
16 16 16 16 16 22 91 7 9 9 9 9 9 9 9 9 9 9 13 1 101 100 66 68 67 40 8 9 9 9 9 9 9 6 12 6 80 21 16 17 16 16 16 22 40 69 5 5 5 5 5 5 5 80 40 40 40 40 40 40 40 40 40 40 40 40 40 40 40 40 40 40 40 40 40 40 40 40 40 40 40 40 40 40 40 40 21 16 16 16 16 16 16 16 16 16 16 16 16 16 
16 16 16 16 16 22 69 12 9 9 9 9 9 9 9 9 9 9 6 80 101 2 3 14 40 91 7 9 9 9 9 9 9 13 7 10 41 21 16 17 16 16 16 22 40 40 40 40 40 40 40 40 40 40 40 40 40 40 40 40 40 40 40 40 40 40 40 40 40 40 40 40 40 40 40 40 40 40 40 40 40 40 40 40 40 40 21 16 16 16 16 16 16 16 16 16 16 16 16 16 
16 16 16 16 16 22 40 69 5 5 5 12 9 9 9 9 9 9 13 1 25 98 98 36 91 7 9 9 9 9 9 9 9 9 9 13 1 21 17 16 16 16 16 22 40 40 40 40 40 40 40 40 40 40 40 40 40 40 40 40 40 40 40 40 40 40 40 40 40 40 40 40 40 40 40 40 40 40 40 40 40 40 40 40 40 40 21 16 16 16 16 16 16 16 16 16 16 16 16 16 
16 16 16 16 16 29 19 20 40 40 40 69 12 9 9 9 9 9 9 13 11 11 11 11 7 9 9 9 9 9 9 9 9 9 9 6 80 21 16 16 16 16 16 29 19 19 19 19 19 19 19 19 19 19 40 40 40 40 40 40 40 40 40 40 40 40 40 40 40 40 40 40 40 40 40 40 40 40 40 40 40 40 40 40 40 40 21 16 16 16 16 16 16 16 16 16 16 16 16 16 
16 16 16 16 16 16 16 29 19 19 19 20 69 12 9 9 9 9 9 9 9 9 9 9 9 9 9 9 9 9 9 9 9 6 5 80 18 30 16 16 16 16 16 16 16 16 16 16 16 16 16 16 16 16 22 40 40 40 40 40 40 40 40 40 40 40 40 40 40 40 40 40 40 40 40 40 40 40 40 40 40 40 40 40 40 40 21 16 16 16 16 16 16 16 16 16 16 16 16 16 
16 16 16 16 16 16 16 16 16 16 16 22 40 8 9 9 9 9 9 9 9 9 9 9 9 9 9 9 9 9 9 9 6 80 40 18 30 16 16 16 16 16 16 16 16 16 16 16 16 16 16 16 16 16 29 19 19 19 19 19 19 19 19 19 19 19 19 19 19 19 19 19 19 19 19 19 19 19 19 19 19 19 19 19 19 19 30 16 16 16 16 16 16 16 16 16 16 16 16 16 
16 16 16 16 16 16 16 16 16 16 16 29 20 69 5 5 5 5 5 5 5 5 5 5 5 5 5 5 5 5 5 5 80 40 18 30 16 16 16 16 16 16 16 16 16 16 16 16 16 16 16 16 16 16 16 16 16 16 16 16 16 16 16 16 16 16 16 16 16 16 16 16 16 16 16 16 16 16 16 16 16 16 16 16 16 16 16 16 16 16 16 16 16 16 16 16 16 16 16 16 
16 16 16 16 16 16 16 16 16 16 16 16 29 19 19 19 19 19 19 19 19 19 19 19 19 19 19 19 19 19 19 19 19 19 30 16 16 16 16 16 16 16 16 16 16 16 16 16 16 16 16 16 16 16 16 16 16 16 16 16 16 16 16 16 16 16 16 16 16 16 16 16 16 16 16 16 16 16 16 16 16 16 16 16 16 16 16 16 16 16 16 16 16 16 16 16 16 16 16 16 
16 16 16 16 16 16 16 16 16 16 16 16 16 16 16 16 16 16 16 16 16 16 16 16 16 16 16 16 16 16 16 16 16 16 16 16 16 16 16 16 16 16 16 16 16 16 16 16 16 16 16 16 16 16 16 16 16 16 16 16 16 16 16 16 16 16 16 16 16 16 16 16 16 16 16 16 16 16 16 16 16 16 16 16 16 16 16 16 16 16 16 16 16 16 16 16 16 16 16 16 
16 16 16 16 16 16 16 16 16 16 16 16 16 16 16 16 16 16 16 16 16 16 16 16 16 16 16 16 16 16 16 16 16 16 16 16 16 16 16 16 16 16 16 16 16 16 16 16 16 16 16 16 16 16 16 16 16 16 16 16 16 16 16 16 16 16 16 16 16 16 16 16 16 16 16 16 16 16 16 16 16 16 16 16 16 16 16 16 16 16 16 16 16 16 16 16 16 16 16 16 
16 16 16 16 16 16 16 16 16 16 16 16 16 16 16 16 16 16 16 16 16 16 16 16 16 16 16 16 16 16 16 16 16 16 16 16 16 16 16 16 16 16 16 16 16 16 16 16 16 16 16 16 16 16 16 16 16 16 16 16 16 16 16 16 16 16 16 16 16 16 16 16 16 16 16 16 16 16 16 16 16 16 16 16 16 16 16 16 16 16 16 16 16 16 16 16 16 16 16 16 
16 16 16 16 16 16 16 16 16 16 16 16 16 16 16 16 16 16 16 16 16 16 16 16 16 16 16 16 16 16 16 16 16 16 16 16 16 16 16 16 16 16 16 16 16 16 16 16 16 16 16 16 16 16 16 16 16 16 16 16 16 16 16 16 16 16 16 16 16 16 16 16 16 16 16 16 16 16 16 16 16 16 16 16 16 16 16 16 16 16 16 16 16 16 16 16 16 16 16 16 
16 16 16 16 16 16 16 16 16 16 16 16 16 16 16 16 16 16 16 16 16 16 16 16 16 16 16 16 16 16 16 16 16 16 16 16 16 16 16 16 16 16 16 16 16 16 16 16 16 16 16 16 16 16 16 16 16 16 16 16 16 16 16 16 16 16 16 16 16 16 16 16 16 16 16 16 16 16 16 16 16 16 16 16 16 16 16 16 16 16 16 16 16 16 16 16 16 16 16 16 
16 16 16 16 16 16 16 16 16 16 16 16 16 16 16 16 16 16 16 16 16 16 16 16 16 16 16 16 16 16 16 16 16 16 16 16 16 16 16 16 16 16 16 16 16 16 16 16 16 16 16 16 16 16 16 16 16 16 16 16 16 16 16 16 16 16 16 16 16 16 16 16 16 16 16 16 16 16 16 16 16 16 16 16 16 16 16 16 16 16 16 16 16 16 16 16 16 16 16 16 
16 16 16 16 16 16 16 16 16 16 16 16 16 16 16 16 16 16 16 16 16 16 16 16 16 16 16 16 16 16 16 16 16 16 16 16 16 16 16 16 16 16 16 16 16 16 16 16 16 16 16 16 16 16 16 16 16 16 16 16 16 16 16 16 16 16 16 16 16 16 16 16 16 16 16 16 16 16 16 16 16 16 16 16 16 16 16 16 16 16 16 16 16 16 16 16 16 16 16 16 
16 16 16 16 16 16 16 16 16 16 16 16 16 16 16 16 16 16 16 16 16 16 16 16 16 16 16 16 16 16 16 16 16 16 16 16 16 16 16 16 16 16 16 16 16 16 16 16 16 16 16 16 16 16 16 16 16 16 16 16 16 16 16 16 16 16 16 16 16 16 16 16 16 16 16 16 16 16 16 16 16 16 16 16 16 16 16 16 16 16 16 16 16 16 16 16 16 16 16 16 
16 16 16 16 16 16 16 16 16 16 16 16 16 16 16 16 16 16 16 16 16 16 16 16 16 16 16 16 16 16 16 16 16 16 16 16 16 16 16 16 16 16 16 16 16 16 16 16 16 16 16 16 16 16 16 16 16 16 16 16 16 16 16 16 16 16 16 16 16 16 16 16 16 16 16 16 16 16 16 16 16 16 16 16 16 16 16 16 16 16 16 16 16 16 16 16 16 16 16 16 
16 16 16 16 16 16 16 16 16 16 16 16 16 16 16 16 16 16 16 16 16 16 16 16 16 16 16 16 16 16 16 16 16 16 16 16 16 16 16 16 16 16 16 16 16 16 16 16 16 16 16 16 16 16 16 16 16 16 16 16 16 16 16 16 16 16 16 16 16 16 16 16 16 16 16 16 16 16 16 16 16 16 16 16 16 16 16 16 16 16 16 16 16 16 16 16 16 16 16 16 
