15 15
100 100 
8 8 8 8 8 8 8 8 8 8 8 8 8 8 8
9 4 12 4 0 0 0 1 1 10 1 1 6 6 9
9 4 12 4 0 0 0 0 0 0 0 0 0 6 9
9 0 12 12 12 12 12 12 12 12 12 12 0 7 9
9 1 12 0 0 0 0 0 0 4 4 12 4 0 9
9 10 12 0 0 0 7 0 0 0 4 12 4 0 9
9 1 12 0 6 6 6 6 6 6 11 5 11 6 9
9 0 12 0 6 6 6 6 6 6 11 5 11 6 9
9 0 12 0 6 6 10 6 6 6 11 5 11 6 9
9 0 12 0 6 6 6 6 6 6 11 5 11 6 9
9 0 12 0 0 0 0 0 0 0 1 12 1 1 9
9 1 12 1 0 0 0 0 0 0 0 12 10 1 9
9 1 12 12 12 12 12 12 12 12 12 12 12 12 9
9 1 1 1 0 0 0 0 4 7 4 12 12 3 9
8 8 8 8 8 8 8 8 8 8 8 8 8 8 8