15 15 
100 100 
8 8 8 8 8 8 8 8 8 8 8 8 8 8 8
9 13 12 12 12 12 12 12 12 12 12 12 6 6 9
9 12 12 12 1 1 12 1 1 1 0 12 6 6 9
9 12 12 4 11 11 5 11 11 4 0 12 10 6 9
9 0 12 4 11 11 5 11 11 4 0 12 6 6 9
9 0 12 4 11 11 5 11 11 4 0 12 0 0 9
9 0 12 1 1 1 12 1 1 1 0 12 0 0 9
9 0 12 0 0 4 12 0 0 7 0 12 0 7 9
9 0 12 0 7 4 12 10 0 0 0 12 0 1 9
9 0 12 4 4 4 12 0 0 0 4 12 0 1 9
9 6 12 12 12 12 12 12 12 12 12 12 0 1 9
9 6 10 0 0 0 0 0 1 12 10 0 0 0 9
9 6 6 6 0 7 0 0 4 12 4 0 7 6 9
9 6 6 6 6 6 0 0 4 12 4 0 6 6 9
8 8 8 8 8 8 8 8 8 8 8 8 8 8 8