34 34 34 34 34 34 34 34 34 35 40 40 40 40 40 32 40 40 40 40 40 40 40 40 33 40 40 40 40 40 40 40 40 40 40 32 40 40 40 40 40 40 40 40 40 40 40 34 34 16 
34 34 34 34 34 34 34 34 40 91 1 40 40 40 40 40 40 40 40 40 40 40 40 40 40 40 40 40 40 40 40 40 40 40 40 40 40 40 32 40 34 34 34 34 34 34 34 34 16 16 
35 34 34 34 34 34 35 40 91 7 10 40 40 40 40 40 40 32 40 40 40 40 32 40 40 40 40 33 40 40 40 40 40 40 40 40 40 40 34 34 34 16 16 16 16 16 16 16 16 16 
34 34 34 34 34 34 34 91 7 6 80 40 40 40 40 40 40 40 40 40 40 40 40 40 91 11 1 40 40 40 40 40 40 40 40 40 34 34 34 34 16 16 16 17 16 16 16 16 16 16 
34 34 34 35 34 34 91 7 6 80 40 40 40 40 40 40 33 40 40 40 40 33 40 40 69 12 10 40 40 40 40 40 40 40 40 40 34 16 16 16 16 16 16 32 32 32 32 32 32 32 
11 11 11 11 11 11 7 6 80 40 40 34 34 34 40 40 40 40 40 40 40 40 40 40 40 69 80 40 40 34 34 34 40 40 34 34 34 16 16 40 43 44 38 38 44 38 38 44 38 38 
9 9 9 9 9 9 9 10 40 40 34 34 34 34 37 34 40 40 40 40 40 40 40 33 40 40 34 34 34 34 34 34 34 34 34 16 16 17 16 40 40 44 38 38 44 38 38 44 38 38 
5 5 5 5 5 5 5 80 40 40 34 34 34 34 34 34 40 40 40 40 40 40 40 40 40 40 34 34 34 34 34 16 16 16 16 16 16 16 40 43 40 44 38 38 44 38 38 44 38 38 
40 40 40 40 40 40 40 41 34 34 34 34 16 16 34 34 40 40 40 40 40 40 34 34 34 34 34 34 16 16 16 16 16 16 16 16 16 43 43 40 43 44 38 38 44 38 38 44 38 38 
40 40 40 40 40 40 40 40 34 34 34 16 16 16 34 34 40 40 40 40 40 34 34 34 34 16 16 16 17 40 40 40 40 40 40 43 40 40 43 43 40 44 38 38 44 38 38 44 38 38 
40 40 42 40 40 41 40 34 37 34 16 16 17 16 34 34 34 34 34 34 34 34 34 16 16 16 16 16 16 40 40 40 40 40 91 11 11 11 11 11 11 11 11 11 11 11 11 11 11 11 
40 40 40 40 40 34 34 34 34 34 16 17 16 16 34 34 34 34 34 34 34 34 16 16 16 17 16 40 40 40 40 40 40 40 8 9 9 9 9 9 9 9 9 9 9 9 9 9 9 9 
19 19 20 40 18 34 16 16 17 16 16 16 16 16 16 34 34 34 34 16 16 16 16 16 16 16 16 16 40 40 40 40 40 91 7 9 9 9 9 9 9 9 9 9 9 9 9 9 9 9 
16 16 22 40 21 16 16 16 16 16 16 16 17 16 16 38 38 16 16 16 16 16 16 42 40 16 16 16 16 16 16 40 40 69 5 5 5 5 5 5 5 5 5 5 5 5 5 5 5 5 
16 17 22 40 21 16 16 16 16 16 16 16 16 16 16 38 38 38 16 16 42 40 44 40 40 34 16 17 16 16 17 16 16 16 40 40 40 40 40 40 40 40 40 40 40 40 42 40 40 40 
24 24 26 33 21 16 17 34 16 16 16 34 16 34 34 40 96 40 40 42 40 40 40 40 40 34 34 34 16 16 16 16 16 17 17 40 40 40 40 40 40 40 40 40 40 40 40 40 42 40 
33 33 33 33 23 24 26 34 16 16 34 34 34 34 40 42 96 40 40 42 40 40 40 40 40 40 40 34 34 34 16 16 16 16 16 33 32 32 32 32 32 32 32 32 32 32 32 40 40 40 
33 33 33 33 33 33 34 34 34 34 40 40 40 40 40 40 96 40 40 40 40 40 40 40 40 40 40 40 40 34 34 34 34 34 34 33 40 90 92 93 40 32 40 90 92 93 32 40 40 40 
40 40 40 40 40 40 42 40 43 40 40 40 40 40 40 40 96 40 40 40 40 40 40 40 41 40 40 40 40 40 40 40 40 40 40 33 42 84 85 86 40 32 41 84 85 86 32 40 40 42 
40 40 40 40 40 40 40 40 40 40 40 40 43 40 42 96 96 96 96 96 96 96 96 96 40 40 40 40 40 40 40 40 40 40 40 33 40 81 82 83 40 32 40 81 82 83 32 40 40 40 
58 76 77 78 40 76 77 78 40 43 40 40 40 40 40 40 40 40 40 40 40 40 40 96 40 40 40 40 40 41 40 40 40 40 40 33 40 87 88 89 42 32 40 87 88 89 32 40 42 40 
58 70 71 72 33 70 71 72 33 40 63 64 65 40 40 40 40 41 40 40 40 40 40 96 40 40 40 40 40 40 40 40 40 40 40 3 3 3 3 3 3 3 3 3 3 14 40 42 40 40 
58 66 68 67 33 66 68 67 33 40 56 57 59 40 40 43 40 40 40 40 40 40 40 96 96 96 96 96 96 96 96 96 96 96 97 98 98 98 98 98 98 98 98 98 98 36 40 40 40 40 
58 73 74 75 33 73 74 75 33 40 53 54 55 95 40 40 40 40 40 41 40 40 40 98 98 98 98 98 98 98 98 98 98 99 100 40 40 40 40 40 40 40 40 40 91 11 11 11 1 40 
40 34 34 34 34 34 34 37 34 41 60 61 62 94 40 40 40 40 40 40 40 40 40 31 31 31 31 31 31 31 31 31 31 101 100 40 40 40 40 40 40 91 11 11 7 9 9 9 13 1 
40 0 3 3 3 3 3 3 3 3 3 3 3 3 3 3 3 3 3 3 3 3 3 3 3 3 3 3 3 3 3 3 3 4 100 40 91 11 11 11 11 7 9 9 9 9 9 9 9 9 
40 101 96 96 96 96 96 96 96 96 96 96 96 96 96 97 98 98 98 98 98 98 99 97 98 98 98 98 98 98 98 98 98 98 36 41 8 9 9 9 9 9 9 9 9 9 6 5 5 5 
40 25 98 98 98 98 98 98 98 98 98 98 98 98 98 36 40 31 40 40 40 40 101 100 40 40 40 40 40 40 40 91 11 11 11 11 7 9 9 9 9 9 9 9 9 9 10 50 51 51 
91 11 11 11 11 11 11 11 11 11 11 11 11 11 11 1 40 31 40 76 77 78 101 100 76 77 78 76 77 78 91 7 9 9 9 9 9 9 9 9 9 9 9 9 9 9 10 45 48 48 
8 9 9 9 9 9 9 9 9 9 9 9 9 9 9 10 40 31 40 70 71 72 101 100 70 71 72 70 71 72 8 9 9 9 9 9 9 9 9 9 9 9 9 9 9 9 10 42 33 50 
8 9 9 9 9 9 9 9 9 9 9 9 9 9 9 10 40 31 40 66 68 67 101 100 66 68 67 66 68 67 8 9 9 9 9 9 9 9 9 9 9 9 9 9 9 9 10 42 33 49 
8 9 9 9 9 9 9 9 9 9 9 9 9 9 9 10 40 31 40 73 74 75 101 100 73 74 75 73 74 75 8 9 9 9 9 9 9 9 9 9 9 9 9 6 5 5 80 42 33 49 
69 5 5 5 5 5 5 5 5 5 5 5 5 5 5 80 40 31 31 31 31 31 101 100 31 31 32 32 32 32 69 5 5 5 5 5 5 5 5 5 5 5 5 80 42 42 42 42 33 45 
48 48 48 48 48 48 48 48 48 48 48 48 48 48 48 48 48 48 48 48 48 48 101 100 40 40 40 40 40 40 40 40 40 40 33 33 33 33 33 33 33 33 33 33 33 33 33 33 33 33 
40 40 91 11 11 11 11 11 11 11 11 11 11 1 40 40 40 40 40 40 40 40 101 100 40 40 40 40 40 40 40 40 40 40 40 40 40 40 40 40 33 40 40 40 40 33 40 40 40 40 
32 40 69 5 5 5 12 9 9 9 9 9 9 13 1 40 40 40 40 40 40 40 101 96 96 96 96 96 96 96 96 96 96 96 40 40 40 76 77 78 33 76 77 78 40 33 76 77 78 40 
32 76 77 78 40 91 7 9 9 9 9 9 9 9 13 11 11 11 1 40 40 40 96 40 40 40 40 40 40 40 40 40 40 96 40 40 40 70 71 72 33 70 71 72 40 33 70 71 72 40 
32 70 71 72 40 69 5 5 5 5 5 5 12 9 9 9 9 9 10 40 40 96 96 40 40 40 40 18 19 19 19 20 40 96 40 40 40 66 68 67 33 66 68 67 40 33 66 68 67 40 
32 66 68 67 40 40 40 40 40 40 40 40 69 5 12 9 9 9 10 40 96 96 40 40 40 40 18 30 16 16 16 22 40 96 40 40 40 73 74 75 33 40 34 34 34 33 40 40 40 40 
32 73 74 75 40 96 96 96 96 96 96 96 96 96 69 5 5 5 80 96 96 40 40 40 40 40 21 16 16 16 16 22 40 96 40 40 40 40 40 40 33 40 34 34 34 33 40 40 40 40 
32 40 96 96 96 96 18 19 19 19 19 19 19 20 96 40 40 40 96 96 40 40 40 40 40 40 21 16 17 16 27 26 40 96 96 96 96 96 96 96 96 96 96 96 96 96 96 96 96 96 
32 40 40 40 40 18 30 16 16 16 16 17 16 29 20 96 96 96 40 91 11 11 11 11 1 40 23 28 16 27 26 40 40 40 40 40 40 40 40 40 40 40 31 40 40 40 31 40 40 40 
32 40 40 18 19 30 16 17 16 16 16 16 16 16 22 40 40 41 11 7 9 9 9 9 10 40 40 23 24 26 40 40 40 41 40 40 40 40 76 77 78 40 31 76 77 78 31 76 77 78 
40 40 40 21 16 16 16 16 16 16 16 16 17 16 22 40 40 8 9 9 9 9 9 9 10 40 40 40 40 40 40 40 40 40 40 40 40 40 70 71 72 40 31 70 71 72 31 70 71 72 
40 40 40 21 16 16 16 16 16 17 16 16 16 27 26 41 91 7 9 9 9 9 9 9 10 18 19 19 19 19 19 19 19 19 19 19 20 40 66 68 67 41 31 66 68 67 32 66 68 67 
40 40 40 23 24 28 16 16 16 16 16 27 24 26 40 91 7 9 9 9 9 9 9 6 80 21 16 16 16 16 16 16 16 16 16 16 22 40 40 40 40 40 40 40 40 40 40 40 40 40 
11 11 11 11 1 23 24 24 24 24 24 26 40 91 11 7 9 9 9 9 9 9 9 10 40 21 16 16 17 16 16 16 16 16 16 16 22 40 40 41 40 40 40 40 40 40 40 44 40 40 
9 9 9 9 13 1 40 43 40 40 40 40 40 69 5 5 5 5 5 5 5 5 5 80 40 21 16 16 16 16 16 17 16 16 16 16 22 40 40 40 40 44 40 40 44 40 40 40 44 40 
9 9 9 9 9 13 1 40 40 40 43 40 40 40 40 40 40 40 40 40 40 42 40 40 40 21 16 16 17 16 16 16 16 16 16 16 29 19 19 20 40 44 40 41 40 40 40 40 40 40 
9 9 9 9 9 9 13 1 40 40 40 40 43 40 40 40 42 42 40 40 40 40 40 40 42 21 16 16 16 16 17 16 16 16 16 16 16 16 16 22 40 40 40 40 40 40 40 41 40 40 