16 16 16 16 16 16 16 16 16 16 16 16 16 16 16 16 16 16 16 16 16 16 16 16 16 16 16 16 16 16 16 16 16 16 16 16 16 16 16 16 16 16 16 16 16 16 16 16 16 16 16 16 16 16 16 16 16 16 16 16 16 16 16 16 16 16 16 16 16 16 16 16 16 16 16 16 16 16 16 16 16 16 16 16 16 16 16 16 16 16 16 16 16 16 16 16 16 16 16 16 
16 16 16 16 16 16 16 16 16 16 16 16 16 16 16 16 16 16 16 16 16 16 16 16 16 16 16 16 16 16 16 16 16 16 16 16 16 16 16 16 16 16 16 16 16 16 16 16 16 16 16 16 16 16 16 16 16 16 16 16 16 16 16 16 16 16 16 16 16 16 16 16 16 16 16 16 16 16 16 16 16 16 16 16 16 16 16 16 16 16 16 16 16 16 16 16 16 16 16 16 
16 16 16 16 16 16 16 16 16 16 16 16 16 16 16 16 16 16 16 16 16 16 16 16 16 16 16 16 16 16 16 16 16 16 16 16 16 16 16 16 16 16 16 16 16 16 16 16 16 16 16 16 16 16 16 16 16 16 16 16 16 16 16 16 16 16 16 16 16 16 16 16 16 16 16 16 16 16 16 16 16 16 16 16 16 16 16 16 16 16 16 16 16 16 16 16 16 16 16 16 
16 16 16 16 16 16 16 16 16 16 16 16 16 16 16 16 16 16 16 16 16 16 16 16 16 16 16 16 16 16 16 16 16 16 16 16 16 16 16 16 16 16 16 16 16 16 16 16 16 16 16 16 16 16 16 16 16 16 16 16 16 16 16 16 16 16 16 16 16 16 16 16 16 16 16 16 16 16 16 16 16 16 16 16 16 16 16 16 16 16 16 16 16 16 16 16 16 16 16 16 
16 16 16 16 16 16 16 16 16 16 16 16 16 16 16 16 16 16 16 16 16 16 16 16 16 16 16 16 16 16 16 16 16 16 16 16 16 16 16 16 16 16 16 16 16 16 16 16 16 16 16 16 16 16 16 16 16 16 16 16 16 16 16 16 16 16 16 16 16 16 16 16 16 16 16 16 16 16 16 16 16 16 16 16 16 16 16 16 16 16 16 16 16 16 16 16 16 16 16 16 
16 16 16 16 16 16 16 16 16 16 16 16 16 16 16 16 16 16 16 16 16 16 16 16 16 16 16 16 16 16 16 16 16 16 16 16 16 16 16 16 16 16 16 16 16 16 16 16 16 16 16 16 16 16 16 16 16 16 16 16 16 16 16 16 16 16 16 16 16 16 16 16 16 16 16 16 16 16 16 16 16 16 16 16 16 16 16 16 16 16 16 16 16 16 16 16 16 16 16 16 
16 16 16 16 16 16 16 16 16 16 16 16 16 16 16 16 16 16 16 16 16 16 16 16 16 16 16 16 16 16 16 16 16 16 16 16 16 16 16 16 16 16 16 16 16 16 16 16 16 16 16 16 16 16 16 16 16 16 16 16 16 16 16 16 16 16 16 16 16 16 16 16 16 16 16 16 16 16 16 16 16 16 16 16 16 16 16 16 16 16 16 16 16 16 16 16 16 16 16 16 
16 16 16 16 16 16 16 16 16 16 16 16 16 16 16 16 16 16 16 16 16 16 16 16 16 16 16 16 16 16 16 16 16 16 16 16 16 16 16 16 16 16 16 16 16 16 16 16 16 16 16 16 16 16 16 16 16 16 16 16 16 16 16 16 16 16 16 16 16 16 16 16 16 16 16 16 16 16 16 16 16 16 16 16 16 16 16 16 16 16 16 16 16 16 16 16 16 16 16 16 
16 16 16 16 16 16 16 16 16 16 16 16 16 16 16 16 16 16 16 16 16 16 16 16 16 16 16 16 16 16 16 16 16 16 16 16 16 16 16 16 16 16 16 16 16 16 16 16 16 16 16 16 16 16 16 16 16 16 16 16 16 16 16 16 16 16 16 16 16 16 16 16 16 16 16 16 16 16 16 16 16 16 16 16 16 16 16 16 16 16 16 16 16 16 16 16 16 16 16 16 
16 16 16 16 16 16 16 16 16 16 16 16 16 16 16 16 16 16 16 16 16 16 16 16 16 16 16 16 16 16 16 16 16 16 16 16 16 16 16 16 16 16 16 16 16 16 16 16 16 16 16 16 16 16 16 16 16 16 16 16 16 16 16 16 16 16 16 16 16 16 16 16 16 16 16 16 16 16 16 16 16 16 16 16 16 16 16 16 16 16 16 16 16 16 16 16 16 16 16 16 
16 16 16 16 16 16 16 16 16 16 16 16 16 16 16 16 16 16 16 16 16 16 16 16 16 16 16 16 16 16 16 16 16 16 16 16 16 16 16 16 16 16 16 16 16 16 16 16 16 16 16 16 16 16 16 16 16 16 16 16 16 16 16 16 16 16 16 16 16 16 16 16 16 16 16 16 16 16 16 16 16 16 16 16 16 16 16 16 16 16 16 16 16 16 16 16 16 16 16 16 
16 16 16 16 16 16 16 16 16 16 16 16 16 16 16 16 16 16 16 16 16 16 16 16 16 16 16 16 16 16 16 16 16 16 16 16 16 16 16 16 16 16 16 16 16 16 16 16 16 16 16 16 16 16 16 16 16 16 16 16 16 16 16 16 16 16 16 16 16 16 16 16 16 16 16 16 16 16 16 16 16 16 16 16 16 16 16 16 16 16 16 16 16 16 16 16 16 16 16 16 
16 16 16 16 16 16 16 16 16 16 16 16 16 16 16 16 16 16 16 16 16 16 16 16 16 16 16 16 16 16 16 16 16 16 16 16 16 16 16 16 16 16 16 16 16 16 16 16 16 16 16 16 16 16 16 16 16 16 16 16 16 16 16 16 16 16 16 16 16 16 16 16 16 16 16 16 16 16 16 16 16 16 16 16 16 16 16 16 16 16 16 16 16 16 16 16 16 16 16 16 
16 16 16 16 16 16 16 16 16 16 16 16 16 16 16 16 16 16 16 16 16 16 16 16 16 16 16 16 16 16 16 16 16 16 16 16 16 16 16 16 16 16 16 16 16 16 16 16 16 16 16 16 16 16 16 16 16 16 16 16 16 16 16 16 16 16 16 16 16 16 16 16 16 16 16 16 16 16 16 16 16 16 16 16 16 16 16 16 16 16 16 16 16 16 16 16 16 16 16 16 
16 16 16 16 16 16 16 16 16 16 16 16 16 16 16 16 16 16 16 16 16 16 16 16 16 16 16 16 16 16 16 16 16 16 16 16 16 16 16 16 16 16 16 16 16 16 16 16 16 16 16 16 16 16 16 16 16 16 16 16 16 16 16 16 16 16 16 16 16 16 16 16 16 16 16 16 16 16 16 16 16 16 16 16 16 16 16 16 16 16 16 16 16 16 16 16 16 16 16 16 
16 16 16 16 16 16 16 16 16 16 16 16 16 16 16 16 16 16 16 16 16 16 16 16 16 16 16 16 16 16 16 16 16 16 16 16 16 16 16 16 16 16 16 16 16 16 16 16 16 16 16 16 16 16 16 16 16 16 16 16 16 16 16 16 16 16 16 16 16 16 16 16 16 16 16 16 16 16 16 16 16 16 16 16 16 16 16 16 16 16 16 16 16 16 16 16 16 16 16 16 
16 16 16 16 16 16 16 16 16 16 16 16 16 16 16 16 16 16 16 16 16 16 16 16 16 16 16 16 16 16 16 16 16 16 16 16 16 16 16 16 16 16 16 16 16 16 16 16 16 16 16 16 16 16 16 16 16 16 16 16 16 16 16 16 16 16 16 16 16 16 16 16 16 16 16 16 16 16 16 16 16 16 16 16 16 16 16 16 16 16 16 16 16 16 16 16 16 16 16 16 
16 16 16 16 16 16 16 16 16 16 16 16 16 16 16 16 16 16 16 16 16 16 16 16 16 16 16 16 16 16 16 16 16 16 16 16 16 16 16 16 16 16 16 16 16 16 16 16 16 16 16 16 16 16 16 16 16 16 16 16 16 16 16 16 16 16 16 16 16 16 16 16 16 16 16 16 16 16 16 16 16 16 16 16 16 16 16 16 16 16 16 16 16 16 16 16 16 16 16 16 
16 16 16 16 16 16 16 16 16 16 16 16 16 16 16 16 16 16 16 16 16 16 16 16 16 16 16 16 16 16 16 16 16 16 16 16 16 16 16 16 16 16 16 16 16 16 16 16 16 16 16 16 16 16 16 16 16 16 16 16 16 16 16 16 16 16 16 16 16 16 16 16 16 16 16 16 16 16 16 16 16 16 16 16 16 16 16 16 16 16 16 16 16 16 16 16 16 16 16 16 
16 16 16 16 16 16 16 16 16 16 16 16 16 16 16 16 16 27 24 24 24 24 24 24 24 24 24 24 24 24 24 24 24 24 24 24 24 24 24 24 24 24 24 34 16 16 34 24 24 24 24 24 24 24 24 24 24 24 24 24 24 24 24 24 24 24 24 24 24 24 24 24 24 24 24 24 24 24 24 24 24 24 28 16 16 16 16 16 16 16 16 16 16 16 16 16 16 16 16 16 
16 16 16 16 16 16 16 16 16 16 16 16 16 16 16 16 16 22 40 43 40 40 40 40 40 40 40 40 40 40 32 32 32 32 32 32 32 32 32 32 32 32 32 34 16 16 34 34 40 40 40 40 40 40 91 11 11 11 11 11 1 40 40 40 40 91 11 11 11 11 11 11 11 11 1 40 40 41 40 40 40 40 21 16 16 16 16 16 16 16 16 16 16 16 16 16 16 16 16 16 
16 16 16 16 16 16 16 16 16 16 16 16 16 16 16 16 16 22 40 40 40 44 44 44 44 44 44 40 40 40 32 40 90 92 93 40 32 40 90 92 93 40 32 34 16 17 16 34 40 40 40 40 40 40 8 9 9 9 9 9 13 1 41 40 91 7 9 9 9 9 9 9 9 9 10 40 40 40 40 40 41 40 21 16 16 16 16 16 16 16 16 16 16 16 16 16 16 16 16 16 
16 16 16 16 16 16 16 16 16 16 16 16 16 16 16 16 16 22 43 40 44 44 44 44 44 44 44 40 40 40 32 40 84 85 86 40 32 40 84 85 86 40 32 34 16 16 16 34 34 40 40 40 40 40 8 9 9 9 9 9 9 10 40 40 8 9 9 9 9 9 9 9 9 9 10 40 40 40 40 40 40 40 21 16 16 16 16 16 16 16 16 16 16 16 16 16 16 16 16 16 
16 16 16 16 16 16 16 16 16 16 16 16 16 16 16 16 16 22 40 40 44 44 44 40 40 40 40 40 40 42 32 40 81 82 83 40 32 40 81 82 83 40 32 34 34 16 16 16 34 34 40 40 40 40 69 12 9 9 9 9 9 10 40 40 8 9 9 9 9 9 9 9 9 9 10 40 40 41 40 40 40 40 21 16 16 16 16 16 16 16 16 16 16 16 16 16 16 16 16 16 
16 16 16 16 16 16 16 16 16 16 16 16 16 16 16 16 16 22 40 44 44 44 44 40 40 40 91 11 11 1 32 40 87 88 89 40 32 40 87 88 89 40 32 34 34 34 16 16 34 34 34 34 40 40 40 69 5 12 9 9 9 10 40 40 69 5 12 9 9 9 9 9 9 9 10 40 40 41 40 41 41 40 21 16 16 16 16 16 16 16 16 16 16 16 16 16 16 16 16 16 
16 16 16 16 16 16 16 16 16 16 16 16 16 16 16 16 16 22 40 40 40 40 40 40 40 42 69 5 5 80 0 3 3 3 3 3 3 3 3 3 3 14 40 40 34 34 16 17 16 34 34 34 34 40 40 40 40 69 5 5 5 80 40 41 40 40 69 12 9 9 9 9 9 6 80 40 40 40 40 41 40 40 21 16 16 16 16 16 16 16 16 16 16 16 16 16 16 16 16 16 
16 16 16 16 16 16 16 16 16 16 16 16 16 16 16 16 16 22 40 40 43 40 40 40 40 40 40 40 40 40 25 98 98 98 98 98 99 97 98 98 98 36 40 40 40 34 34 16 16 16 16 16 34 34 34 40 40 40 40 40 40 40 40 40 40 40 40 69 5 5 5 5 12 13 11 11 11 11 11 1 40 40 21 16 16 16 16 16 16 16 16 16 16 16 16 16 16 16 16 16 
16 16 16 16 16 16 16 16 16 16 16 16 16 16 16 16 16 22 40 40 40 42 43 42 40 40 18 19 19 19 19 19 19 19 19 20 101 100 18 19 19 20 40 40 40 40 34 34 16 16 17 16 16 34 34 40 40 40 40 40 40 41 40 40 40 40 41 40 40 40 40 40 69 12 9 9 9 9 9 13 11 1 21 16 16 16 16 16 16 16 16 16 16 16 16 16 16 16 16 16 
16 16 16 16 16 16 16 16 16 16 16 16 16 16 16 16 16 22 40 40 40 40 40 40 40 40 21 16 16 16 16 16 16 16 16 22 101 100 21 16 16 29 19 20 40 40 34 34 34 34 34 16 16 16 34 34 34 40 40 40 40 40 40 40 40 40 40 40 40 40 40 40 40 8 9 9 9 9 9 9 9 10 21 16 16 16 16 16 16 16 16 16 16 16 16 16 16 16 16 16 
16 16 16 16 16 16 16 16 16 16 16 16 16 16 16 16 16 22 40 40 40 40 40 40 40 40 21 16 16 16 17 16 16 16 17 22 101 100 21 16 16 16 17 29 20 91 11 1 34 34 34 34 16 16 16 34 34 34 34 34 40 40 40 41 40 40 40 40 41 40 40 40 40 8 9 9 9 9 9 9 9 10 21 16 16 16 16 16 16 16 16 16 16 16 16 16 16 16 16 16 
16 16 16 16 16 16 16 16 16 16 16 16 16 16 16 16 16 22 40 40 40 40 40 40 40 40 23 28 16 16 16 16 16 16 16 22 101 100 21 16 17 16 16 16 22 8 9 13 1 40 34 34 34 16 16 22 40 21 34 34 34 34 40 40 40 40 40 40 40 40 40 40 40 69 5 5 5 5 5 5 5 80 21 16 16 16 16 16 16 16 16 16 16 16 16 16 16 16 16 16 
16 16 16 16 16 16 16 16 16 16 16 16 16 16 16 16 16 22 40 40 40 40 40 40 40 40 40 21 16 16 16 16 17 16 16 22 101 100 21 16 17 16 17 16 22 8 9 9 13 11 1 34 34 34 16 22 40 21 16 16 34 34 34 40 40 40 40 40 40 40 40 40 40 40 40 40 40 40 40 40 40 40 21 16 16 16 16 16 16 16 16 16 16 16 16 16 16 16 16 16 
16 16 16 16 16 16 16 16 16 16 16 16 16 16 16 16 16 22 40 40 40 40 40 40 40 40 40 23 24 28 16 16 16 16 16 22 101 100 21 16 16 16 16 16 22 8 9 9 9 9 10 40 34 34 34 34 40 21 16 16 16 16 34 34 34 34 34 34 34 34 34 34 40 40 40 40 40 40 40 40 40 40 21 16 16 16 16 16 16 16 16 16 16 16 16 16 16 16 16 16 
16 16 16 16 16 16 16 16 16 16 16 16 16 16 16 16 16 22 40 40 40 40 40 40 40 40 40 40 40 23 24 24 24 24 24 26 101 100 23 24 24 24 24 24 26 69 5 5 5 5 80 40 40 40 34 40 40 34 34 16 17 16 16 16 16 34 34 34 34 34 34 34 34 40 40 40 40 40 40 41 40 40 21 16 16 16 16 16 16 16 16 16 16 16 16 16 16 16 16 16 
16 16 16 16 16 16 16 16 16 16 16 16 16 16 16 16 16 22 40 40 40 91 11 11 11 11 11 11 11 11 11 1 40 40 40 40 101 2 3 3 3 3 3 3 3 3 3 3 3 3 3 3 3 3 14 40 40 34 34 34 16 16 16 16 16 16 16 16 17 16 16 34 34 34 34 34 40 40 40 40 40 40 21 16 16 16 16 16 16 16 16 16 16 16 16 16 16 16 16 16 
16 16 16 16 16 16 16 16 16 16 16 16 16 16 16 16 16 22 40 41 91 7 9 9 9 9 9 9 9 9 9 10 40 40 40 40 25 98 98 98 98 98 98 98 98 98 98 98 98 98 98 98 99 96 100 40 40 40 34 34 16 16 17 16 16 16 16 16 16 16 16 16 16 34 34 34 34 34 34 34 34 34 21 16 16 16 16 16 16 16 16 16 16 16 16 16 16 16 16 16 
16 16 16 16 16 16 16 16 16 16 16 16 16 16 16 16 16 22 40 40 8 9 9 9 9 9 9 9 9 9 9 10 40 40 40 40 43 43 43 43 43 43 43 43 40 91 11 11 11 11 11 1 101 96 100 40 40 40 34 34 16 16 16 16 16 34 34 34 34 16 16 16 16 17 16 16 34 34 34 34 34 34 34 16 16 16 16 16 16 16 16 16 16 16 16 16 16 16 16 16 
16 16 16 16 16 16 16 16 16 16 16 16 16 16 16 16 16 22 40 40 8 9 9 9 9 9 9 9 9 9 9 10 40 40 40 40 43 43 43 43 43 43 43 40 40 8 9 9 9 9 9 10 101 96 100 40 40 40 34 34 16 16 16 16 16 34 34 34 34 34 34 16 16 16 16 16 16 17 16 16 16 16 16 16 16 16 16 16 16 16 16 16 16 16 16 16 16 16 16 16 
16 16 16 16 16 16 16 16 16 16 16 16 16 16 27 24 24 26 40 40 69 12 9 9 9 9 9 9 9 6 5 80 40 40 40 40 40 40 40 40 40 40 40 40 40 8 9 9 9 9 9 10 101 96 100 40 40 40 34 34 24 24 24 24 24 34 40 40 40 40 34 34 34 34 16 16 16 16 16 16 16 16 16 16 16 16 16 16 16 16 16 16 16 16 16 16 16 16 16 16 
16 16 16 16 16 16 16 16 16 16 16 16 16 16 22 40 40 40 40 40 40 8 9 9 9 9 9 9 6 80 40 40 40 40 40 40 40 40 40 40 40 40 40 40 40 8 9 9 9 9 9 10 101 96 100 40 40 40 34 34 40 40 40 40 40 34 40 40 40 40 34 34 34 34 34 34 34 34 34 34 34 34 34 16 16 16 16 16 16 16 16 16 16 16 16 16 16 16 16 16 
16 16 16 16 16 16 16 16 16 16 16 16 16 16 22 43 43 43 43 43 40 69 5 5 5 5 5 5 80 40 40 40 40 40 40 40 40 40 40 40 40 40 40 40 40 8 9 9 9 9 9 10 101 96 100 40 40 40 40 34 34 19 19 19 19 34 40 40 40 40 40 40 40 40 40 40 40 40 40 40 40 40 21 16 16 16 16 16 16 16 16 16 16 16 16 16 16 16 16 16 
16 16 16 16 16 16 16 16 16 16 16 16 16 16 22 43 43 43 43 40 40 40 40 40 40 40 40 40 40 40 40 40 40 40 40 40 40 40 40 40 40 40 40 40 40 8 9 9 9 9 9 10 101 96 100 91 11 11 1 34 34 16 16 16 16 34 34 40 40 40 40 40 40 44 44 44 44 44 44 44 44 44 21 16 16 16 16 16 16 16 16 16 16 16 16 16 16 16 16 16 
16 16 16 16 16 16 16 16 16 16 16 16 16 16 22 43 43 43 40 40 40 40 40 40 40 40 40 40 40 40 40 40 40 40 40 40 40 40 40 40 40 40 40 40 40 8 9 9 9 9 9 10 101 96 100 8 9 9 10 34 34 34 16 16 16 34 34 40 40 40 40 40 41 44 38 38 38 38 38 38 38 44 21 16 16 16 16 16 16 16 16 16 16 16 16 16 16 16 16 16 
16 16 16 16 16 16 16 16 16 16 16 16 16 16 22 43 43 43 40 33 33 33 33 33 33 33 33 33 33 33 33 33 33 33 33 33 33 33 33 33 33 33 33 33 40 8 9 9 9 9 9 10 101 96 100 8 9 9 10 34 34 34 16 17 16 16 34 34 40 40 40 40 42 44 38 38 38 38 38 38 38 44 21 16 16 16 16 16 16 16 16 16 16 16 16 16 16 16 16 16 
16 16 16 16 16 16 16 16 16 16 16 16 16 16 22 43 43 43 40 33 40 40 40 40 41 40 40 33 40 40 40 40 40 40 40 33 40 40 40 40 40 40 40 33 40 8 9 9 9 9 9 10 101 96 100 8 9 9 10 40 34 34 34 16 16 16 34 34 34 34 40 42 42 44 44 44 44 44 44 44 44 44 21 16 16 16 16 16 16 16 16 16 16 16 16 16 16 16 16 16 
16 16 16 16 16 16 16 16 16 16 16 16 16 16 22 43 43 43 40 33 40 32 40 40 40 40 40 33 40 42 40 40 40 31 40 33 40 40 40 40 40 42 40 33 40 8 9 9 9 9 9 10 101 96 100 8 9 9 10 40 40 34 34 34 16 16 16 34 34 34 34 34 40 44 38 38 38 38 38 38 38 44 21 16 16 16 16 16 16 16 16 16 16 16 16 16 16 16 16 16 
16 16 16 16 16 16 16 16 16 16 16 16 16 16 22 43 43 40 40 33 40 40 63 64 65 40 40 33 40 40 76 77 78 40 40 33 40 40 76 77 78 40 40 33 40 8 9 9 9 9 9 10 101 96 100 8 9 9 10 40 40 40 34 34 34 16 16 16 16 34 35 34 40 44 38 38 38 38 38 38 38 44 21 16 16 16 16 16 16 16 16 16 16 16 16 16 16 16 16 16 
16 16 16 16 16 16 16 16 16 16 16 16 16 16 22 40 40 40 40 33 40 40 56 57 59 41 40 33 40 40 70 71 72 40 40 33 40 40 70 71 72 40 40 33 40 8 9 9 9 9 9 10 101 96 100 8 9 9 10 40 40 40 34 34 34 34 34 16 16 16 16 34 34 44 44 44 44 44 44 44 44 44 21 16 16 16 16 16 16 16 16 16 16 16 16 16 16 16 16 16 
16 16 16 16 16 16 16 16 16 16 16 16 16 16 22 40 43 40 40 33 40 40 53 54 55 40 40 33 40 40 66 68 67 40 40 33 40 40 66 68 67 40 40 33 40 8 9 9 9 9 9 10 101 96 100 8 9 9 10 40 40 40 40 40 34 34 34 34 16 16 16 16 34 34 34 34 34 34 40 40 40 40 23 24 28 16 16 16 16 16 16 16 16 16 16 16 16 16 16 16 
16 16 16 16 16 16 16 16 16 16 16 16 16 16 22 43 43 40 40 33 40 40 60 61 62 40 40 33 40 40 40 40 42 40 40 33 42 40 40 40 40 42 40 33 40 8 9 9 9 9 9 10 101 96 100 8 9 9 10 40 40 40 40 40 40 40 34 34 34 16 16 17 16 34 34 34 34 34 34 34 34 34 34 34 34 16 16 16 16 16 16 16 16 16 16 16 16 16 16 16 
16 16 16 16 16 16 16 16 16 16 16 16 16 16 22 43 40 40 40 33 43 40 0 3 14 40 40 33 40 40 0 3 14 40 40 33 40 40 0 3 14 40 40 33 40 69 5 5 5 5 5 80 101 96 100 69 5 5 80 40 40 40 40 40 40 40 40 40 34 34 16 16 16 16 16 16 16 16 16 16 16 16 16 16 16 16 16 16 16 16 16 16 16 16 16 16 16 16 16 16 
16 16 16 16 16 16 16 16 16 16 16 16 16 16 22 91 1 40 41 40 40 40 101 96 2 3 3 3 3 3 4 96 2 3 3 3 3 3 4 96 2 3 3 3 3 3 3 3 3 3 3 3 4 96 100 40 40 40 40 40 91 11 11 11 11 1 40 40 34 34 34 34 16 16 16 16 16 17 16 16 16 16 16 16 16 16 27 24 24 28 16 16 16 16 16 16 16 16 16 16 
16 16 16 16 16 16 16 16 16 16 16 16 16 16 22 69 80 40 40 40 40 40 101 96 96 96 96 96 96 96 96 96 96 96 96 96 96 96 96 96 96 96 96 96 96 96 96 96 96 96 96 96 96 96 100 40 40 40 40 40 8 9 9 9 9 13 1 40 40 40 34 34 34 34 34 34 34 34 34 34 16 16 16 16 16 27 26 91 1 23 24 28 16 16 16 16 16 16 16 16 
16 16 16 16 16 16 16 16 16 16 16 16 16 16 22 40 40 43 40 40 41 40 101 96 97 98 98 98 98 98 99 96 97 98 98 98 98 98 99 96 97 98 98 98 98 98 98 98 98 98 98 98 99 96 100 40 40 40 40 40 8 9 9 9 9 9 9 1 40 40 40 34 34 34 34 34 34 34 34 34 34 16 24 16 27 26 91 7 13 11 1 23 28 16 16 16 16 16 16 16 
16 16 16 16 16 16 16 16 16 16 16 16 16 16 22 40 40 40 40 40 40 40 101 96 100 40 40 41 40 40 101 96 100 40 40 40 40 40 101 96 100 40 40 33 40 40 40 40 40 40 40 40 101 96 100 40 40 40 40 91 7 9 9 9 9 9 9 13 1 40 40 40 40 40 40 40 40 40 40 40 40 40 40 16 22 91 7 9 9 9 13 1 23 24 24 24 28 16 16 16 
16 16 16 16 16 16 16 16 16 16 16 16 16 16 22 40 40 40 40 33 40 40 101 96 100 40 40 33 40 40 101 96 100 40 40 33 40 40 101 96 100 40 40 33 40 40 40 40 40 40 40 40 101 96 100 40 40 40 40 8 9 9 9 9 9 9 9 9 10 40 40 40 42 42 43 43 40 40 44 44 40 44 44 94 91 7 9 9 9 9 9 13 11 11 11 1 23 24 24 24 
16 16 16 16 16 16 16 16 16 16 16 16 16 16 22 40 40 40 40 33 40 40 25 98 36 40 40 33 40 40 25 98 36 41 40 33 40 40 25 98 36 40 40 33 40 40 40 40 40 40 40 40 101 96 100 40 40 40 40 69 5 5 5 12 9 9 9 9 10 40 40 40 40 40 40 40 42 42 40 40 42 42 42 91 7 9 9 9 9 9 9 9 9 9 9 13 11 11 11 11 
16 16 16 16 16 16 16 16 16 16 16 16 16 16 22 40 43 40 40 33 40 42 76 77 78 40 40 33 40 40 76 77 78 42 40 33 40 40 76 77 78 40 40 33 40 40 40 40 9 40 40 40 101 96 100 40 40 40 40 40 40 40 40 69 12 6 5 5 80 40 40 40 44 44 40 40 43 43 43 40 42 42 91 7 9 9 9 9 9 9 9 9 9 9 9 9 9 9 9 9 
16 16 16 16 16 16 16 16 16 16 16 16 16 16 22 40 40 40 40 33 40 40 70 71 72 40 40 33 40 40 70 71 72 40 40 33 40 40 70 71 72 42 40 33 40 40 9 9 9 40 40 40 101 96 100 40 43 43 43 43 43 43 43 40 69 80 43 43 43 40 40 40 42 42 40 40 40 40 40 40 40 91 7 9 9 9 9 9 9 9 9 9 9 9 9 9 9 9 9 9 
16 16 16 16 16 16 16 16 16 16 16 16 16 16 22 40 40 40 40 33 40 40 66 68 67 40 40 33 40 40 66 68 67 40 40 33 40 40 66 68 67 40 40 33 40 40 9 9 9 40 40 40 101 96 100 40 43 43 43 43 43 43 43 43 43 43 43 43 40 40 40 40 43 43 43 43 40 44 44 44 40 8 9 9 9 9 9 9 9 9 9 9 9 9 9 9 9 9 9 9 
16 16 16 16 16 16 16 16 16 16 16 16 16 16 22 40 40 40 40 33 40 40 40 40 40 40 40 33 40 40 40 40 40 40 40 33 40 40 40 40 40 40 40 33 40 40 40 40 40 40 40 40 101 96 100 40 40 40 40 40 40 40 40 40 40 40 40 40 40 40 40 40 40 40 40 40 40 40 40 40 40 69 12 9 9 9 9 9 9 9 9 9 9 9 9 9 9 9 9 9 
16 16 16 16 16 16 16 16 16 16 16 16 16 16 22 43 40 40 40 33 40 44 40 40 40 42 40 33 40 44 44 44 40 40 40 33 32 44 44 44 44 31 40 33 40 40 40 40 40 40 40 40 101 96 2 3 3 3 3 3 3 3 3 3 3 3 3 3 3 3 3 3 3 3 3 3 3 3 3 3 3 3 8 9 9 9 9 9 9 9 9 9 9 9 9 9 9 9 9 9 
16 16 16 16 16 16 16 16 16 16 16 16 16 16 22 43 43 43 40 33 33 33 33 33 33 33 33 33 33 33 33 33 33 33 33 33 33 33 33 33 33 33 33 33 33 33 40 40 40 40 40 40 25 98 98 98 98 98 98 98 99 97 98 98 98 98 98 98 98 98 98 98 98 98 98 98 98 98 98 98 98 98 8 9 9 9 9 9 9 9 9 9 9 9 9 9 9 9 9 9 
16 16 16 16 16 16 16 16 16 16 16 16 16 16 22 43 43 43 43 40 40 40 40 40 40 40 40 40 40 40 40 40 40 40 40 40 40 40 40 40 40 40 40 40 40 40 40 40 40 40 40 40 40 40 40 40 40 40 40 40 101 100 40 40 40 40 40 40 40 40 40 40 40 40 40 40 40 40 40 40 40 91 7 9 9 9 9 9 9 9 9 9 9 9 9 9 9 9 9 9 
16 16 16 16 16 16 16 16 16 16 16 16 16 16 22 40 43 43 43 40 40 40 40 43 40 40 40 40 40 40 40 40 40 40 40 40 40 0 3 3 3 3 3 3 3 3 14 40 18 19 19 19 19 19 19 19 19 19 20 40 101 100 91 11 11 11 11 11 11 11 11 1 40 40 40 40 40 40 40 40 91 7 9 9 9 9 9 9 9 9 9 9 9 9 9 9 9 9 9 9 
16 16 16 16 16 16 16 16 16 16 16 16 16 16 22 43 43 43 43 40 40 40 40 40 40 40 40 40 40 40 40 40 40 40 40 40 40 101 97 98 98 98 98 98 98 98 36 18 30 16 16 16 16 16 16 16 16 17 22 40 101 100 8 9 9 9 9 9 9 9 9 10 40 40 40 40 40 40 40 91 7 9 9 6 5 5 5 5 5 5 5 5 5 5 5 5 5 5 5 5 
16 16 16 16 16 16 16 16 16 16 16 16 16 16 22 43 43 43 43 40 40 40 40 40 40 40 40 40 40 40 40 40 40 40 40 40 40 101 100 40 40 40 40 40 40 40 40 21 16 16 16 16 16 16 16 16 27 24 26 40 101 100 8 9 9 9 9 9 9 9 9 10 40 40 40 40 40 40 91 7 9 9 9 10 18 19 19 19 19 19 19 19 19 19 19 19 19 19 19 19 
16 16 16 16 16 16 16 16 16 16 16 16 16 16 22 40 40 40 40 40 0 3 3 3 3 3 3 3 3 3 3 3 3 3 3 3 3 4 2 3 14 91 11 11 1 40 40 21 16 16 17 16 16 17 16 16 29 19 20 40 101 100 8 9 9 9 9 9 9 9 9 10 40 40 91 11 11 11 7 9 9 9 9 10 21 16 16 16 16 16 16 16 16 16 16 16 16 16 16 16 
16 16 16 16 16 16 16 16 16 16 16 16 16 16 22 40 40 40 43 40 101 97 98 98 98 98 98 98 98 98 98 98 98 98 98 98 98 98 98 99 100 8 9 9 10 40 40 21 16 16 16 16 16 16 16 16 16 27 26 40 101 100 69 12 9 9 9 9 9 9 6 80 40 91 7 9 9 9 9 9 9 9 9 10 21 16 16 16 16 16 16 16 16 16 16 16 16 16 16 16 
16 16 16 16 16 16 16 16 16 16 16 16 16 16 22 40 40 43 43 40 101 100 40 42 42 42 42 42 42 42 40 40 40 40 40 40 40 40 40 101 100 8 9 9 10 40 40 21 16 16 17 16 16 16 27 24 24 26 40 40 101 100 40 69 12 9 9 9 9 6 80 40 40 8 9 9 9 9 9 9 9 9 9 10 21 16 16 16 16 16 16 16 16 16 16 16 16 16 16 16 
16 16 16 16 16 16 16 16 16 16 16 16 16 16 22 40 32 32 32 32 101 100 40 42 43 43 43 43 43 42 40 18 19 19 19 19 19 20 40 101 100 8 9 9 10 40 40 23 28 16 16 16 16 27 26 40 40 40 40 40 101 100 40 40 69 5 5 5 5 80 40 40 40 8 9 9 9 9 9 9 9 9 9 10 21 16 16 16 16 16 16 16 16 16 16 16 16 16 16 16 
16 16 16 16 16 16 16 16 16 16 16 16 16 16 22 40 76 77 78 40 101 100 40 42 43 43 43 43 43 42 40 21 16 16 16 16 16 29 20 101 100 69 12 9 10 40 40 40 23 24 24 24 24 26 40 40 40 40 40 40 101 100 40 40 40 40 40 40 40 40 40 91 11 7 9 9 9 9 9 9 9 9 9 10 21 16 16 16 16 16 16 16 16 16 16 16 16 16 16 16 
16 16 16 16 16 16 16 16 16 16 16 16 16 16 22 40 70 71 72 40 101 100 40 42 38 38 38 38 38 42 40 21 17 16 16 16 16 16 22 101 100 40 69 12 13 11 1 40 40 40 40 42 42 40 40 40 40 40 40 40 101 100 40 40 40 40 40 40 40 40 40 8 9 9 9 9 9 9 9 9 9 9 9 10 21 16 16 16 16 16 16 16 16 16 16 16 16 16 16 16 
16 16 16 16 16 16 16 16 16 16 16 16 16 16 22 40 66 68 67 40 101 100 40 42 44 44 44 44 44 42 18 30 16 16 16 16 16 16 22 101 100 40 40 69 12 9 13 1 40 40 40 42 42 40 40 40 40 40 40 40 101 100 40 40 40 40 40 40 40 40 91 7 9 9 9 9 9 9 9 9 9 9 6 80 21 16 16 16 16 16 16 16 16 16 16 16 16 16 16 16 
16 16 16 16 16 16 16 16 16 16 16 16 16 16 22 40 40 40 40 40 101 100 40 42 38 38 38 38 38 42 21 16 16 17 16 16 17 27 26 101 100 40 40 40 69 5 12 10 40 40 40 42 42 40 40 40 40 40 40 40 101 100 40 40 40 40 40 40 40 91 7 9 9 9 9 9 9 9 9 9 9 6 80 40 21 16 16 16 16 16 16 16 16 16 16 16 16 16 16 16 
16 16 16 16 16 16 16 16 16 16 16 16 16 16 29 19 19 19 19 20 101 100 40 42 44 44 44 44 44 42 23 28 16 16 16 16 27 26 40 101 100 40 40 40 40 40 69 80 40 0 3 3 3 3 3 3 3 3 3 3 4 100 40 40 40 40 40 40 91 7 9 9 9 9 9 9 9 9 9 9 9 10 40 94 21 16 16 16 16 16 16 16 16 16 16 16 16 16 16 16 
16 16 16 16 16 16 16 16 16 16 16 16 16 16 16 16 16 16 16 22 101 100 40 42 43 43 43 43 43 42 40 23 24 28 16 27 26 40 40 101 100 40 40 40 40 40 40 40 40 101 97 98 98 98 98 98 98 98 98 98 98 36 40 40 40 40 40 40 8 9 9 9 9 9 9 9 9 9 9 9 6 80 34 34 21 16 16 16 16 16 16 16 16 16 16 16 16 16 16 16 
16 16 16 16 16 16 16 16 16 16 16 16 16 16 16 16 16 16 16 22 101 100 40 42 43 43 43 43 43 42 40 40 40 23 24 26 40 40 40 101 2 3 3 3 3 3 3 3 3 4 100 40 40 40 40 40 40 40 40 40 40 40 40 40 40 40 40 40 8 9 9 9 9 9 9 9 9 9 6 5 80 40 34 34 21 16 16 16 16 16 16 16 16 16 16 16 16 16 16 16 
16 16 16 16 16 16 16 16 16 16 16 16 16 16 16 16 16 16 16 22 101 100 40 42 42 42 42 42 42 42 40 40 40 40 40 40 40 40 40 25 98 98 98 98 98 98 98 98 98 98 36 40 91 11 11 1 40 40 40 43 43 43 43 43 43 43 40 40 69 5 12 9 9 9 9 9 9 6 80 40 34 34 34 34 21 16 16 16 16 16 16 16 16 16 16 16 16 16 16 16 
16 16 16 16 16 16 16 16 16 16 16 16 16 16 16 16 16 16 16 22 101 100 40 40 40 40 40 40 40 40 40 40 40 40 40 40 40 40 40 40 40 40 40 40 40 40 91 11 11 11 11 11 7 9 9 13 1 40 43 43 43 43 43 43 43 40 40 40 40 40 69 5 5 5 5 5 5 80 34 35 34 34 34 34 21 16 16 16 16 16 16 16 16 16 16 16 16 16 16 16 
16 16 16 16 16 16 16 16 16 16 16 16 16 16 16 16 16 16 16 22 101 100 76 77 78 40 40 40 40 40 43 40 40 40 40 40 40 18 19 19 19 19 19 20 40 91 7 9 9 9 9 9 9 9 9 9 10 40 40 40 40 43 43 40 40 40 40 40 40 40 40 40 40 40 40 40 40 34 34 34 34 34 34 34 21 16 16 16 16 16 16 16 16 16 16 16 16 16 16 16 
16 16 16 16 16 16 16 16 16 16 16 16 16 16 16 16 16 16 16 22 101 100 70 71 72 40 44 38 44 38 44 38 44 40 40 18 19 30 16 16 16 16 16 22 40 8 9 9 9 9 9 9 9 9 9 9 10 40 40 40 40 40 40 40 40 40 40 40 40 40 40 40 40 40 34 34 34 34 34 34 34 34 35 34 21 16 16 16 16 16 16 16 16 16 16 16 16 16 16 16 
16 16 16 16 16 16 16 16 16 16 16 16 16 16 16 16 16 16 16 22 101 100 66 68 67 40 44 38 44 38 44 38 44 40 40 21 16 16 16 16 16 16 16 22 40 69 5 5 5 5 5 5 5 5 5 5 80 40 40 40 40 40 40 40 40 40 40 40 40 40 40 40 40 34 34 35 34 34 34 34 34 34 34 34 21 16 16 16 16 16 16 16 16 16 16 16 16 16 16 16 
16 16 16 16 16 16 16 16 16 16 16 16 16 16 16 16 16 16 16 22 101 2 3 14 40 40 44 38 44 38 44 38 44 40 18 30 16 16 16 16 16 16 16 22 40 40 40 40 40 40 40 40 40 40 40 40 40 40 40 40 40 40 40 40 40 40 40 40 40 40 40 40 34 34 34 34 34 34 34 34 34 34 35 34 21 16 16 16 16 16 16 16 16 16 16 16 16 16 16 16 
16 16 16 16 16 16 16 16 16 16 16 16 16 16 16 16 16 16 16 22 25 98 98 36 40 40 44 38 44 38 44 38 44 40 21 16 16 16 16 16 16 16 16 22 40 40 40 40 40 40 40 40 40 40 40 40 40 40 40 40 40 40 40 40 40 40 40 40 40 40 40 40 40 40 34 34 34 34 34 34 34 34 34 34 21 16 16 16 16 16 16 16 16 16 16 16 16 16 16 16 
16 16 16 16 16 16 16 16 16 16 16 16 16 16 16 16 16 16 16 29 19 19 19 19 19 19 19 19 19 19 19 19 19 19 30 16 16 16 16 16 16 16 16 29 19 19 19 19 19 19 19 19 19 19 19 19 19 19 19 19 19 19 19 19 19 19 19 19 19 19 19 19 19 19 19 19 19 19 19 19 19 19 19 19 30 16 16 16 16 16 16 16 16 16 16 16 16 16 16 16 
16 16 16 16 16 16 16 16 16 16 16 16 16 16 16 16 16 16 16 16 16 16 16 16 16 16 16 16 16 16 16 16 16 16 16 16 16 16 16 16 16 16 16 16 16 16 16 16 16 16 16 16 16 16 16 16 16 16 16 16 16 16 16 16 16 16 16 16 16 16 16 16 16 16 16 16 16 16 16 16 16 16 16 16 16 16 16 16 16 16 16 16 16 16 16 16 16 16 16 16 
16 16 16 16 16 16 16 16 16 16 16 16 16 16 16 16 16 16 16 16 16 16 16 16 16 16 16 16 16 16 16 16 16 16 16 16 16 16 16 16 16 16 16 16 16 16 16 16 16 16 16 16 16 16 16 16 16 16 16 16 16 16 16 16 16 16 16 16 16 16 16 16 16 16 16 16 16 16 16 16 16 16 16 16 16 16 16 16 16 16 16 16 16 16 16 16 16 16 16 16 
16 16 16 16 16 16 16 16 16 16 16 16 16 16 16 16 16 16 16 16 16 16 16 16 16 16 16 16 16 16 16 16 16 16 16 16 16 16 16 16 16 16 16 16 16 16 16 16 16 16 16 16 16 16 16 16 16 16 16 16 16 16 16 16 16 16 16 16 16 16 16 16 16 16 16 16 16 16 16 16 16 16 16 16 16 16 16 16 16 16 16 16 16 16 16 16 16 16 16 16 
16 16 16 16 16 16 16 16 16 16 16 16 16 16 16 16 16 16 16 16 16 16 16 16 16 16 16 16 16 16 16 16 16 16 16 16 16 16 16 16 16 16 16 16 16 16 16 16 16 16 16 16 16 16 16 16 16 16 16 16 16 16 16 16 16 16 16 16 16 16 16 16 16 16 16 16 16 16 16 16 16 16 16 16 16 16 16 16 16 16 16 16 16 16 16 16 16 16 16 16 
16 16 16 16 16 16 16 16 16 16 16 16 16 16 16 16 16 16 16 16 16 16 16 16 16 16 16 16 16 16 16 16 16 16 16 16 16 16 16 16 16 16 16 16 16 16 16 16 16 16 16 16 16 16 16 16 16 16 16 16 16 16 16 16 16 16 16 16 16 16 16 16 16 16 16 16 16 16 16 16 16 16 16 16 16 16 16 16 16 16 16 16 16 16 16 16 16 16 16 16 
16 16 16 16 16 16 16 16 16 16 16 16 16 16 16 16 16 16 16 16 16 16 16 16 16 16 16 16 16 16 16 16 16 16 16 16 16 16 16 16 16 16 16 16 16 16 16 16 16 16 16 16 16 16 16 16 16 16 16 16 16 16 16 16 16 16 16 16 16 16 16 16 16 16 16 16 16 16 16 16 16 16 16 16 16 16 16 16 16 16 16 16 16 16 16 16 16 16 16 16 
16 16 16 16 16 16 16 16 16 16 16 16 16 16 16 16 16 16 16 16 16 16 16 16 16 16 16 16 16 16 16 16 16 16 16 16 16 16 16 16 16 16 16 16 16 16 16 16 16 16 16 16 16 16 16 16 16 16 16 16 16 16 16 16 16 16 16 16 16 16 16 16 16 16 16 16 16 16 16 16 16 16 16 16 16 16 16 16 16 16 16 16 16 16 16 16 16 16 16 16 
16 16 16 16 16 16 16 16 16 16 16 16 16 16 16 16 16 16 16 16 16 16 16 16 16 16 16 16 16 16 16 16 16 16 16 16 16 16 16 16 16 16 16 16 16 16 16 16 16 16 16 16 16 16 16 16 16 16 16 16 16 16 16 16 16 16 16 16 16 16 16 16 16 16 16 16 16 16 16 16 16 16 16 16 16 16 16 16 16 16 16 16 16 16 16 16 16 16 16 16 
16 16 16 16 16 16 16 16 16 16 16 16 16 16 16 16 16 16 16 16 16 16 16 16 16 16 16 16 16 16 16 16 16 16 16 16 16 16 16 16 16 16 16 16 16 16 16 16 16 16 16 16 16 16 16 16 16 16 16 16 16 16 16 16 16 16 16 16 16 16 16 16 16 16 16 16 16 16 16 16 16 16 16 16 16 16 16 16 16 16 16 16 16 16 16 16 16 16 16 16 
16 16 16 16 16 16 16 16 16 16 16 16 16 16 16 16 16 16 16 16 16 16 16 16 16 16 16 16 16 16 16 16 16 16 16 16 16 16 16 16 16 16 16 16 16 16 16 16 16 16 16 16 16 16 16 16 16 16 16 16 16 16 16 16 16 16 16 16 16 16 16 16 16 16 16 16 16 16 16 16 16 16 16 16 16 16 16 16 16 16 16 16 16 16 16 16 16 16 16 16 
16 16 16 16 16 16 16 16 16 16 16 16 16 16 16 16 16 16 16 16 16 16 16 16 16 16 16 16 16 16 16 16 16 16 16 16 16 16 16 16 16 16 16 16 16 16 16 16 16 16 16 16 16 16 16 16 16 16 16 16 16 16 16 16 16 16 16 16 16 16 16 16 16 16 16 16 16 16 16 16 16 16 16 16 16 16 16 16 16 16 16 16 16 16 16 16 16 16 16 16 
16 16 16 16 16 16 16 16 16 16 16 16 16 16 16 16 16 16 16 16 16 16 16 16 16 16 16 16 16 16 16 16 16 16 16 16 16 16 16 16 16 16 16 16 16 16 16 16 16 16 16 16 16 16 16 16 16 16 16 16 16 16 16 16 16 16 16 16 16 16 16 16 16 16 16 16 16 16 16 16 16 16 16 16 16 16 16 16 16 16 16 16 16 16 16 16 16 16 16 16 
16 16 16 16 16 16 16 16 16 16 16 16 16 16 16 16 16 16 16 16 16 16 16 16 16 16 16 16 16 16 16 16 16 16 16 16 16 16 16 16 16 16 16 16 16 16 16 16 16 16 16 16 16 16 16 16 16 16 16 16 16 16 16 16 16 16 16 16 16 16 16 16 16 16 16 16 16 16 16 16 16 16 16 16 16 16 16 16 16 16 16 16 16 16 16 16 16 16 16 16 
16 16 16 16 16 16 16 16 16 16 16 16 16 16 16 16 16 16 16 16 16 16 16 16 16 16 16 16 16 16 16 16 16 16 16 16 16 16 16 16 16 16 16 16 16 16 16 16 16 16 16 16 16 16 16 16 16 16 16 16 16 16 16 16 16 16 16 16 16 16 16 16 16 16 16 16 16 16 16 16 16 16 16 16 16 16 16 16 16 16 16 16 16 16 16 16 16 16 16 16 
